30 100
CGCAAAAAAACAACATATTAGCAAGAAAGT|CAATCAACTAATAAGCATCGGCAATCAACC
TTACAGGTCGCCAATCGGAAGTCTAATAAG|AACATATTAGCAAGAAAGTATGGACGATCA
TACCAGAACACTAACTCGGAAGTCTAATAA|AGGATCTACTAAAATCGCCTTCACTGCTCA
AAGCGAGGACCTCTCGGAAGTCTAATAAGC|CGGCAATCAACGTACTATCGGAAGTCTAAT
ACAGCTGCACGTCGAGAGTTACTCTGCGTC|ATGCGATGCTAGTTCTATATCTGTCAGGAC
GCAATCAACTCGGAAGTCTCGGAAGTCTAA|GGCAATCAACGTTCGGAAGTCTAATAAGCA
CGCGTCCGATCTGGGGTGGGCACCAGTAAT|GGAGATATAACATGTGACTATAATTTCGAT
AACTAACAACATCTGCCGTTGGATGAACGG|CGCGTCCGATCTGGGGTGGGCACCAGTAAT
GTCGTTCCATCTACGCTCTCAAGTCGGAAG|TGTCACTGCCAGTTATTCTCTAATTAAGAT
GGAGTAACATATGTATCATGTAGCGACACG|TCGGCTCGGTCGTTCCATCTACGCTCTCAA
AATTATGGATCGAAACCTGTCACTGCCAGT|GATCTTCACTGAGCTCACACGACATGTTAG
AACCTGTCACTGCCAGTTATTCTCTAATTA|CTCACACGACATGTTAGGATGAAGACGGGG
TGCTCAAAGCCTCGGAAGTCTAATAAGCAT|AGTCTAATAAGCATCGGCAATCAACCAACC
TGGATGAACGGTGTCACTCGGCTCGGTCGT|GCACCAGTAATTATGGATCGAAACCTGTCA
GGGCAGGCCTATAAGCGGTCACCTTTAAAG|CGACACGCTCGGAAGTCTAATAAGCATCGG
GCATCGGCAATCAACTTGGCTAAACCAATC|GTAGCCAAGGTTAGGGTGATGATGAAGGTA
AGCATCGGCAATCAACCGGTAGGAAATCCG|AACCCCACCTCTTGTCGAATGTGCAAGATC
GTCGCCAATCGGAAGTCTAATAAGCATCGG|TTAGCAAGAAAGTATGGACGATCAGATTCG
TTAAGATGCACGCCCAAGGATTTCTACATT|GGGACGGCGTTTACGTTCTTAAAGCTTTCC
AAAAACAACATATTAGCAAGAAAGTATGGA|AACTAATAAGCATCGGCAATCAACCGGTAG
CATCTGGAGTACCAGAACACTAACTCGGAA|ACGCTAATAAGGATCTACTAAAATCGCCTT
TGGGAGTAATTTGCGCAAAAAAACAACATA|TAATAAGCATCGGCAATCAACTAATAAGCA
CACGTGGATAAAGGAGCGGTCAATCTGATT|TGCGTCGGAAGTCTAATAAGCATCGGCAAT
AGTCTAATAAGCATCGGCAATCAACTCGGA|AAGTCTAATAAGCATCGGCAATCAACGTTC
GCATCGGCAATCAACGTACTATCGGAAGTC|GCATCGGCAATCAACTTCGGAAGTCTAATA
CACGCCCAAGGATTTCTACATTGTAGGGGG|GTTTACGTTCTTAAAGCTTTCCAAAATTTC
CATATTAGCAAGAAAGTATGGACGATCAGA|AGCATCGGCAATCAACCGGTAGGAAATCCG
CAATCAACTACCTGACACTTCTCGGGTGGC|CGCCAATCGGAAGTCTAATAAGCATCGGCA
TCATGTAGCGACACGCTCGGAAGTCTAATA|CATCTACGCTCTCAAGTCGGAAGTCTAATA
CGTCTCAAGTGTTAAGCTGGGCAGGCCTAT|AACATATGTATCATGTAGCGACACGCTCGG
TAAGGATCTACTAAAATCGCCTTCACTGCT|AGTCTAATAAGCATCGGCAATTCGGAAGTC
ATAAGCATCGGCAATCAACTTCGGAAGTCT|GCCCAAGGATTTCTACATTGTAGGGGGAAG
AAAGCGAGGACCTCTCGGAAGTCTAATAAG|TCGGCAATCAACGTACTATCGGAAGTCTAA
GCTCTCAAGTCGGAAGTCTAATAAGCATCG|ATTCTCTAATTAAGATGCACGCCCAAGGAT
AAGTCTAATAAGCATCGGCAATCAACGTTA|TATGGACGATCAGATTCGGTAATTGTTTCA
GAAGTCTAATAAGCATCGGCAATCAACTTC|AGATGCACGCCCAAGGATTTCTACATTGTA
AAGTCTAATAAGCATCGGCAATTCGGAAGT|TCGGAAGTCTAATAAGCATCGGCAATCAAC
ATCAACTCGGAAGTCTCGGAAGTCTAATAA|AATCAACGTTCGGAAGTCTAATAAGCATCG
CGTTCCATCTACGCTCTCAAGTCGGAAGTC|TCACTGCCAGTTATTCTCTAATTAAGATGC
GCACCAGTAATTATGGATCGAAACCTGTCA|ATAATTTCGATCTTCACTGAGCTCACACGA
ACGCTAATAAGGATCTACTAAAATCGCCTT|TCTCGGAAGTCTAATAAGCATCGGCAATTC
CACAGCTGCACGTCGAGAGTTACTCTGCGT|TATGCGATGCTAGTTCTATATCTGTCAGGA
TGGGCAGGCCTATAAGCGGTCACCTTTAAA|GCGACACGCTCGGAAGTCTAATAAGCATCG
AATAAGCATCGGCAATCAACCAAGTACCGC|CAATCAACCGTCTCAAGTGTTAAGCTGGGC
TCGGAAGTCTAATAAGCATCGGCAATCAAC|ACCACTTAAGTAACTTACAGGTCGCCAATC
AAGTCTAATAAGCATCGGCAATCAACTAAT|AATAAGCATCGGCAATCAACCAAGTACCGC
ACCTCTCGGAAGTCTAATAAGCATCGGCAA|AACGTACTATCGGAAGTCTAATAAGCATCG
GGTGGCACACTCTGGGAGTAATTTGCGCAA|GTCTCGGAAGTCTAATAAGCATCGGCAATC
AAGTCTAATAAGCATCGGCAATCAACGACG|GGGAAGATGCGCTACATTTCGTACAAAGGG
TAAAGCGAGGACCTCTCGGAAGTCTAATAA|ATCGGCAATCAACGTACTATCGGAAGTCTA
TCGGAAGTCTAATAAGCATCGGCAATTCGG|ACTATCGGAAGTCTAATAAGCATCGGCAAT
CAATCAACGTACTATCGGAAGTCTAATAAG|CAATCAACTTCGGAAGTCTAATAAGCATCG
TGCCCCACGGACACCGGTGGCACACTCTGG|GCAATCAACTCGGAAGTCTCGGAAGTCTAA
AGGCCTATAAGCGGTCACCTTTAAAGCGAG|ACGCTCGGAAGTCTAATAAGCATCGGCAAT
GGCAATCAACGACGCGTCCGATCTGGGGTG|TTTCGTACAAAGGGAGATATAACATGTGAC
AAGCATCGGCAATCAACCGTCTCAAGTGTT|CCAACCCCGACTGGAGTAACATATGTATCA
TTCATACCTATATATCGGAAGTCTAATAAG|TACCAGAACACTAACTCGGAAGTCTAATAA
ATCAACTAACAACATCTGCCGTTGGATGAA|CGACGCGTCCGATCTGGGGTGGGCACCAGT
ACCTATATATCGGAAGTCTAATAAGCATCG|GAACACTAACTCGGAAGTCTAATAAGCATC
AGTAGCCAAGGTTAGGGTGATGATGAAGGT|GTTATCGCCTGAGCCCACACAAGGTCGCAC
TCTCGGAAGTCTAATAAGCATCGGCAATCA|AAGTCTAATAAGCATCGGCAATCAACCAAG
ATGGATCGAAACCTGTCACTGCCAGTTATT|TTCACTGAGCTCACACGACATGTTAGGATG
TATGGACGATCAGATTCGGTAATTGTTTCA|CGGTAGGAAATCCGGCACATCTGGAGTACC
GGAGTGCCCCACGGACACCGGTGGCACACT|ATCGGCAATCAACTCGGAAGTCTCGGAAGT
GGTACAATCTCTCGTTTATGCGATGCTAGT|CACGGGAGTGCCCCACGGACACCGGTGGCA
AACGGTGTCACTCGGCTCGGTCGTTCCATC|GTAATTATGGATCGAAACCTGTCACTGCCA
GGCAATTCGGAAGTCTAATAAGCATCGGCA|CATCGGCAATCAACTAACAACATCTGCCGT
ACAATCTCTCGTTTATGCGATGCTAGTTCT|GGGAGTGCCCCACGGACACCGGTGGCACAC
TACCTGACACTTCTCGGGTGGCCCCGAGAG|GGAAGTCTAATAAGCATCGGCAATCAACGT
ATGCACGCCCAAGGATTTCTACATTGTAGG|GGCGTTTACGTTCTTAAAGCTTTCCAAAAT
AGATTCGGTAATTGTTTCATACCTATATAT|CCGGCACATCTGGAGTACCAGAACACTAAC
ATCAACCAACCCCGACTGGAGTAACATATG|TGGATGAACGGTGTCACTCGGCTCGGTCGT
AGTAATTTGCGCAAAAAAACAACATATTAG|AAGCATCGGCAATCAACTAATAAGCATCGG
AGCATCGGCAATCAACCAACCCCGACTGGA|CATCTGCCGTTGGATGAACGGTGTCACTCG
TTAGGGTGATGATGAAGGTACAATCTCTCG|AGCCCACACAAGGTCGCACGGGAGTGCCCC
TCGCCTGAGCCCACACAAGGTCGCACGGGA|TACCTATATATCGGAAGTCTAATAAGCATC
GCAGGCCTATAAGCGGTCACCTTTAAAGCG|ACACGCTCGGAAGTCTAATAAGCATCGGCA
GGGTGGCCCCGAGAGTAGCCAAGGTTAGGG|ATCGGCAATCAACGTTATCGCCTGAGCCCA
CCGACTGGAGTAACATATGTATCATGTAGC|TGTCACTCGGCTCGGTCGTTCCATCTACGC
GGCCTATAAGCGGTCACCTTTAAAGCGAGG|CGCTCGGAAGTCTAATAAGCATCGGCAATC
ACACGCTCGGAAGTCTAATAAGCATCGGCA|CTCAAGTCGGAAGTCTAATAAGCATCGGCA
AGATGCGCTACATTTCGTACAAAGGGAGAT|TGGGCGACCCGCTCCCCAATAAGGTCTTGA
AACAACATCTGCCGTTGGATGAACGGTGTC|TCCGATCTGGGGTGGGCACCAGTAATTATG
ATGTATCATGTAGCGACACGCTCGGAAGTC|CGTTCCATCTACGCTCTCAAGTCGGAAGTC
AAACATCACAGCTGCACGTCGAGAGTTACT|CTCGTTTATGCGATGCTAGTTCTATATCTG
TTGCGCAAAAAAACAACATATTAGCAAGAA|CGGCAATCAACTAATAAGCATCGGCAATCA
TAATAAGGATCTACTAAAATCGCCTTCACT|GGAAGTCTAATAAGCATCGGCAATTCGGAA
ACATCTGCCGTTGGATGAACGGTGTCACTC|ATCTGGGGTGGGCACCAGTAATTATGGATC
CGCTAATAAGGATCTACTAAAATCGCCTTC|CTCGGAAGTCTAATAAGCATCGGCAATTCG
AAGTCTAATAAGCATCGGCAATCAACTAAC|TAATAAGCATCGGCAATCAACGACGCGTCC
TATCTGTCAGGACCACTTAAGTAACTTACA|CTGGGAGTAATTTGCGCAAAAAAACAACAT
TAAGATGCACGCCCAAGGATTTCTACATTG|GGACGGCGTTTACGTTCTTAAAGCTTTCCA
TATCGGAAGTCTAATAAGCATCGGCAATCA|GAAGTCTAATAAGCATCGGCAATCAACGAC
ACGCCCAAGGATTTCTACATTGTAGGGGGA|TTTACGTTCTTAAAGCTTTCCAAAATTTCC
ATCGGCAATCAACGTTATCGCCTGAGCCCA|ATTCGGTAATTGTTTCATACCTATATATCG
TAATAAGCATCGGCAATCAACCGTCTCAAG|TCAACCAACCCCGACTGGAGTAACATATGT
TTGGATGAACGGTGTCACTCGGCTCGGTCG|GGCACCAGTAATTATGGATCGAAACCTGTC
ACCCCACCTCTTGTCGAATGTGCAAGATCG|GCCTATAAGCGGTCACCTTTAAAGCGAGGA
CTAATAAGCATCGGCAATCAACTACCTGAC|AGTAACTTACAGGTCGCCAATCGGAAGTCT
AAGATGCACGCCCAAGGATTTCTACATTGT|GACGGCGTTTACGTTCTTAAAGCTTTCCAA
TCGGCTCGGTCGTTCCATCTACGCTCTCAA|TCGAAACCTGTCACTGCCAGTTATTCTCTA
CCGCAAACCCCACCTCTTGTCGAATGTGCA|GGGCAGGCCTATAAGCGGTCACCTTTAAAG
GATGCACGCCCAAGGATTTCTACATTGTAG|CGGCGTTTACGTTCTTAAAGCTTTCCAAAA
ATCTGATTCCTCACAGGCACTGCGCGTCGG|TCGGCAATCAACTACCTGACACTTCTCGGG
CAACCAAGTACCGCAAACCCCACCTCTTGT|GTGTTAAGCTGGGCAGGCCTATAAGCGGTC
CAAGAAAGTATGGACGATCAGATTCGGTAA|CAATCAACCGGTAGGAAATCCGGCACATCT
CACACAAGGTCGCACGGGAGTGCCCCACGG|CGGAAGTCTAATAAGCATCGGCAATCAACT
GCTCAAAGCCTCGGAAGTCTAATAAGCATC|GTCTAATAAGCATCGGCAATCAACCAACCC
GAAGGTACAATCTCTCGTTTATGCGATGCT|TCGCACGGGAGTGCCCCACGGACACCGGTG
ACACAAGGTCGCACGGGAGTGCCCCACGGA|GGAAGTCTAATAAGCATCGGCAATCAACTC
ATAAGCATCGGCAATCAACGTTATCGCCTG|GATCAGATTCGGTAATTGTTTCATACCTAT
GATCTGGGGTGGGCACCAGTAATTATGGAT|TAACATGTGACTATAATTTCGATCTTCACT
TCGAAACCTGTCACTGCCAGTTATTCTCTA|TGAGCTCACACGACATGTTAGGATGAAGAC
AAGTCTAATAAGCATCGGCAATCAACCGTC|GGCAATCAACCAACCCCGACTGGAGTAACA
ATATATCGGAAGTCTAATAAGCATCGGCAA|ACTAACTCGGAAGTCTAATAAGCATCGGCA
AACACTAACTCGGAAGTCTAATAAGCATCG|TACTAAAATCGCCTTCACTGCTCAAAGCCT
CGATGCTAGTTCTATATCTGTCAGGACCAC|ACCGGTGGCACACTCTGGGAGTAATTTGCG
CGAATGTGCAAGATCGTAACGCTAATAAGG|ACCTTTAAAGCGAGGACCTCTCGGAAGTCT
AAGCCTCGGAAGTCTAATAAGCATCGGCAA|ATAAGCATCGGCAATCAACCAACCCCGACT
CTGATTCCTCACAGGCACTGCGCGTCGGAA|GGCAATCAACTACCTGACACTTCTCGGGTG
CAACTCGGAAGTCTCGGAAGTCTAATAAGC|TCAACGTTCGGAAGTCTAATAAGCATCGGC
AGGACCTCTCGGAAGTCTAATAAGCATCGG|ATCAACGTACTATCGGAAGTCTAATAAGCA
AAGCATCGGCAATCAACCAACCCCGACTGG|ACATCTGCCGTTGGATGAACGGTGTCACTC
TAATAAGCATCGGCAATCAACGTTATCGCC|ACGATCAGATTCGGTAATTGTTTCATACCT
GGAAGTCTAATAAGCATCGGCAATCAACTT|GGTGGCCCCGAGAGTAGCCAAGGTTAGGGT
AAGTGTTAAGCTGGGCAGGCCTATAAGCGG|TGTATCATGTAGCGACACGCTCGGAAGTCT
AACCAAGTACCGCAAACCCCACCTCTTGTC|TGTTAAGCTGGGCAGGCCTATAAGCGGTCA
CATCACAGCTGCACGTCGAGAGTTACTCTG|GTTTATGCGATGCTAGTTCTATATCTGTCA
AATAAGCATCGGCAATCAACGTACTATCGG|AATAAGCATCGGCAATCAACTTCGGAAGTC
CTAATAAGCATCGGCAATCAACGTTCGGAA|CTGCTCAAAGCCTCGGAAGTCTAATAAGCA
CATCGGCAATCAACGTTCGGAAGTCTAATA|AGCCTCGGAAGTCTAATAAGCATCGGCAAT
CGGAAGTCTAATAAGCATCGGCAATCAACG|GCCTTCACTGCTCAAAGCCTCGGAAGTCTA
CCCAAGGATTTCTACATTGTAGGGGGAAGA|ACGTTCTTAAAGCTTTCCAAAATTTCCTGG
CGGCAATCAACTTGGCTAAACCAATCTGAG|CCAAGGTTAGGGTGATGATGAAGGTACAAT
AATCAACCGGTAGGAAATCCGGCACATCTG|TCTTGTCGAATGTGCAAGATCGTAACGCTA
CAACGTTCGGAAGTCTAATAAGCATCGGCA|GTCTAATAAGCATCGGCAATCAACCGTCTC
AACATATTAGCAAGAAAGTATGGACGATCA|TAAGCATCGGCAATCAACCGGTAGGAAATC
GCAATCAACTTGGCTAAACCAATCTGAGTC|AAGGTTAGGGTGATGATGAAGGTACAATCT
ACGGTGTCACTCGGCTCGGTCGTTCCATCT|TAATTATGGATCGAAACCTGTCACTGCCAG
TCGTAACGCTAATAAGGATCTACTAAAATC|GGACCTCTCGGAAGTCTAATAAGCATCGGC
TGCACTAAACTACGCTAACACGTGGATAAA|GCACGTCGAGAGTTACTCTGCGTCGGAAGT
GGAAGTCTAATAAGCATCGGCAATCAACCA|ATCAACTAACAACATCTGCCGTTGGATGAA
AAGCATCGGCAATCAACTAACAACATCTGC|TCGGCAATCAACGACGCGTCCGATCTGGGG
GTTAAGCTGGGCAGGCCTATAAGCGGTCAC|TCATGTAGCGACACGCTCGGAAGTCTAATA
TCTAATAAGCATCGGCAATCAACTAATAAG|AAGCATCGGCAATCAACCAAGTACCGCAAA
CAAACCCCACCTCTTGTCGAATGTGCAAGA|CAGGCCTATAAGCGGTCACCTTTAAAGCGA
CAACGACGCGTCCGATCTGGGGTGGGCACC|ACAAAGGGAGATATAACATGTGACTATAAT
CGGAAGTCTAATAAGCATCGGCAATCAACT|TCGGAAGTCTAATAAGCATCGGCAATCAAC
TAAGCATCGGCAATCAACGTACTATCGGAA|TAAGCATCGGCAATCAACTTCGGAAGTCTA
AGTTCTATATCTGTCAGGACCACTTAAGTA|GCACACTCTGGGAGTAATTTGCGCAAAAAA
CAATCGGAAGTCTAATAAGCATCGGCAATC|AAGAAAGTATGGACGATCAGATTCGGTAAT
ACGATCAGATTCGGTAATTGTTTCATACCT|GGAAATCCGGCACATCTGGAGTACCAGAAC
GGCAATCAACGTTCGGAAGTCTAATAAGCA|TCGGAAGTCTAATAAGCATCGGCAATCAAC
CTGCGACTTTGACAACGTATGCACTAAACT|TGAGTCAAACATCACAGCTGCACGTCGAGA
AATAAGCATCGGCAATCAACTTGGCTAAAC|CGAGAGTAGCCAAGGTTAGGGTGATGATGA
GTTCGGAAGTCTAATAAGCATCGGCAATCA|AATAAGCATCGGCAATCAACCGTCTCAAGT
CTACATTGTAGGGGGAAGATGCGCTACATT|GCTTTCCAAAATTTCCTGGGCGACCCGCTC
TGCGCAAAAAAACAACATATTAGCAAGAAA|GGCAATCAACTAATAAGCATCGGCAATCAA
GCAAAAAAACAACATATTAGCAAGAAAGTA|AATCAACTAATAAGCATCGGCAATCAACCG
CATCGGCAATCAACGACGCGTCCGATCTGG|TACATTTCGTACAAAGGGAGATATAACATG
TACATTGTAGGGGGAAGATGCGCTACATTT|CTTTCCAAAATTTCCTGGGCGACCCGCTCC
ACAACATCTGCCGTTGGATGAACGGTGTCA|CCGATCTGGGGTGGGCACCAGTAATTATGG
CGGAAGTCTAATAAGCATCGGCAATCAACG|CGGAAGTCTAATAAGCATCGGCAATCAACT
GTATCATGTAGCGACACGCTCGGAAGTCTA|TTCCATCTACGCTCTCAAGTCGGAAGTCTA
AGTGCCCCACGGACACCGGTGGCACACTCT|CGGCAATCAACTCGGAAGTCTCGGAAGTCT
CATCGGCAATCAACGTACTATCGGAAGTCT|CATCGGCAATCAACTTCGGAAGTCTAATAA
ATCAACGTTATCGCCTGAGCCCACACAAGG|AATTGTTTCATACCTATATATCGGAAGTCT
ATGCTAGTTCTATATCTGTCAGGACCACTT|CGGTGGCACACTCTGGGAGTAATTTGCGCA
GAGTAATTTGCGCAAAAAAACAACATATTA|TAAGCATCGGCAATCAACTAATAAGCATCG
GTCTCAAGTGTTAAGCTGGGCAGGCCTATA|ACATATGTATCATGTAGCGACACGCTCGGA
GCGACACGCTCGGAAGTCTAATAAGCATCG|GCTCTCAAGTCGGAAGTCTAATAAGCATCG
TAATAAGCATCGGCAATCAACGTTCGGAAG|TGCTCAAAGCCTCGGAAGTCTAATAAGCAT
AACAACATATTAGCAAGAAAGTATGGACGA|TAATAAGCATCGGCAATCAACCGGTAGGAA
CACTCGGCTCGGTCGTTCCATCTACGCTCT|GGATCGAAACCTGTCACTGCCAGTTATTCT
CAATTCGGAAGTCTAATAAGCATCGGCAAT|TCGGCAATCAACTAACAACATCTGCCGTTG
CAATCAACCGTCTCAAGTGTTAAGCTGGGC|ACTGGAGTAACATATGTATCATGTAGCGAC
GTCGGAAGTCTAATAAGCATCGGCAATCAA|GACCACTTAAGTAACTTACAGGTCGCCAAT
GTCGGAAGTCTAATAAGCATCGGCAATCAA|ATTAAGATGCACGCCCAAGGATTTCTACAT
ATCTGAGTCAAACATCACAGCTGCACGTCG|GTACAATCTCTCGTTTATGCGATGCTAGTT
CAATCAACTTGGCTAAACCAATCTGAGTCA|AGGTTAGGGTGATGATGAAGGTACAATCTC
AACGTTCGGAAGTCTAATAAGCATCGGCAA|TCTAATAAGCATCGGCAATCAACCGTCTCA
GAAGTCTAATAAGCATCGGCAATTCGGAAG|ATCGGAAGTCTAATAAGCATCGGCAATCAA
AAGCATCGGCAATCAACTCGGAAGTCTCGG|TAAGCATCGGCAATCAACGTTCGGAAGTCT
TGTAGCGACACGCTCGGAAGTCTAATAAGC|CTACGCTCTCAAGTCGGAAGTCTAATAAGC
GCAATCAACTAATAAGCATCGGCAATCAAC|AACCAAGTACCGCAAACCCCACCTCTTGTC
TAGGAAATCCGGCACATCTGGAGTACCAGA|TGTGCAAGATCGTAACGCTAATAAGGATCT
GAAGTCTAATAAGCATCGGCAATCAACGTT|CTTCACTGCTCAAAGCCTCGGAAGTCTAAT
AAGGATCTACTAAAATCGCCTTCACTGCTC|GTCTAATAAGCATCGGCAATTCGGAAGTCT
GCTCGGTCGTTCCATCTACGCTCTCAAGTC|AAACCTGTCACTGCCAGTTATTCTCTAATT
CTAACAACATCTGCCGTTGGATGAACGGTG|CGTCCGATCTGGGGTGGGCACCAGTAATTA
GGTCAATCTGATTCCTCACAGGCACTGCGC|AAGCATCGGCAATCAACTACCTGACACTTC
TCGGAAGTCTAATAAGCATCGGCAATCAAC|CATCGGCAATCAACCAACCCCGACTGGAGT
TGCTAGTTCTATATCTGTCAGGACCACTTA|GGTGGCACACTCTGGGAGTAATTTGCGCAA
ACTTTGACAACGTATGCACTAAACTACGCT|CAAACATCACAGCTGCACGTCGAGAGTTAC
CTACCTGACACTTCTCGGGTGGCCCCGAGA|CGGAAGTCTAATAAGCATCGGCAATCAACG
CTGGGCAGGCCTATAAGCGGTCACCTTTAA|AGCGACACGCTCGGAAGTCTAATAAGCATC
AAGCATCGGCAATCAACTTGGCTAAACCAA|GAGTAGCCAAGGTTAGGGTGATGATGAAGG
TCAACCAAGTACCGCAAACCCCACCTCTTG|AGTGTTAAGCTGGGCAGGCCTATAAGCGGT
TGGATAAAGGAGCGGTCAATCTGATTCCTC|TCGGAAGTCTAATAAGCATCGGCAATCAAC
ACTCGGAAGTCTCGGAAGTCTAATAAGCAT|AACGTTCGGAAGTCTAATAAGCATCGGCAA
CGGCAATCAACGTTATCGCCTGAGCCCACA|TCGGTAATTGTTTCATACCTATATATCGGA
CTAATAAGCATCGGCAATCAACCGTCTCAA|ATCAACCAACCCCGACTGGAGTAACATATG
CACTAAACTACGCTAACACGTGGATAAAGG|ACGTCGAGAGTTACTCTGCGTCGGAAGTCT
CTGCCAGTTATTCTCTAATTAAGATGCACG|CATGTTAGGATGAAGACGGGGACGGCGTTT
AATAAGGATCTACTAAAATCGCCTTCACTG|GAAGTCTAATAAGCATCGGCAATTCGGAAG
GGCTAAACCAATCTGAGTCAAACATCACAG|GATGATGAAGGTACAATCTCTCGTTTATGC
AAGGTACAATCTCTCGTTTATGCGATGCTA|CGCACGGGAGTGCCCCACGGACACCGGTGG
TTGTTTCATACCTATATATCGGAAGTCTAA|GGAGTACCAGAACACTAACTCGGAAGTCTA
ACCAAGTACCGCAAACCCCACCTCTTGTCG|GTTAAGCTGGGCAGGCCTATAAGCGGTCAC
GAAGTCTAATAAGCATCGGCAATCAACCAA|TCAACTAACAACATCTGCCGTTGGATGAAC
GTAGGGGGAAGATGCGCTACATTTCGTACA|AAAATTTCCTGGGCGACCCGCTCCCCAATA
TAATAAGCATCGGCAATCAACTTCGGAAGT|ACGCCCAAGGATTTCTACATTGTAGGGGGA
AATCAACTAACAACATCTGCCGTTGGATGA|ACGACGCGTCCGATCTGGGGTGGGCACCAG
AGTTACTCTGCGTCGGAAGTCTAATAAGCA|ATATCTGTCAGGACCACTTAAGTAACTTAC
CTACGCTAACACGTGGATAAAGGAGCGGTC|GAGTTACTCTGCGTCGGAAGTCTAATAAGC
ATCGCCTGAGCCCACACAAGGTCGCACGGG|ATACCTATATATCGGAAGTCTAATAAGCAT
TGGAGTAACATATGTATCATGTAGCGACAC|CTCGGCTCGGTCGTTCCATCTACGCTCTCA
CACAGGCACTGCGCGTCGGAAGTCTAATAA|CTACCTGACACTTCTCGGGTGGCCCCGAGA
CTCTCAAGTCGGAAGTCTAATAAGCATCGG|TTCTCTAATTAAGATGCACGCCCAAGGATT
CCGTTGGATGAACGGTGTCACTCGGCTCGG|GTGGGCACCAGTAATTATGGATCGAAACCT
CTGAGCCCACACAAGGTCGCACGGGAGTGC|TATATATCGGAAGTCTAATAAGCATCGGCA
CATCGGCAATCAACCGGTAGGAAATCCGGC|CCCCACCTCTTGTCGAATGTGCAAGATCGT
ACCTCTTGTCGAATGTGCAAGATCGTAACG|TAAGCGGTCACCTTTAAAGCGAGGACCTCT
CGGAAGTCTAATAAGCATCGGCAATCAACC|ATCGGCAATCAACCAACCCCGACTGGAGTA
ACAGGTCGCCAATCGGAAGTCTAATAAGCA|CATATTAGCAAGAAAGTATGGACGATCAGA
AAATCCGGCACATCTGGAGTACCAGAACAC|CAAGATCGTAACGCTAATAAGGATCTACTA
TCAAGTGTTAAGCTGGGCAGGCCTATAAGC|TATGTATCATGTAGCGACACGCTCGGAAGT
AATAAGCATCGGCAATCAACTAATAAGCAT|CATCGGCAATCAACCAAGTACCGCAAACCC
TCGGAAGTCTAATAAGCATCGGCAATCAAC|TCGGAAGTCTAATAAGCATCGGCAATCAAC
CTGGAGTACCAGAACACTAACTCGGAAGTC|CTAATAAGGATCTACTAAAATCGCCTTCAC
CTATAAGCGGTCACCTTTAAAGCGAGGACC|TCGGAAGTCTAATAAGCATCGGCAATCAAC
ATCGGCAATCAACTACCTGACACTTCTCGG|CAGGTCGCCAATCGGAAGTCTAATAAGCAT
TACGCTAACACGTGGATAAAGGAGCGGTCA|AGTTACTCTGCGTCGGAAGTCTAATAAGCA
ACCGTCTCAAGTGTTAAGCTGGGCAGGCCT|GTAACATATGTATCATGTAGCGACACGCTC
CTCTCGTTTATGCGATGCTAGTTCTATATC|TGCCCCACGGACACCGGTGGCACACTCTGG
TACCTATATATCGGAAGTCTAATAAGCATC|AGAACACTAACTCGGAAGTCTAATAAGCAT
TATGGATCGAAACCTGTCACTGCCAGTTAT|CTTCACTGAGCTCACACGACATGTTAGGAT
TAACGCTAATAAGGATCTACTAAAATCGCC|CCTCTCGGAAGTCTAATAAGCATCGGCAAT
TCAACTAACAACATCTGCCGTTGGATGAAC|GACGCGTCCGATCTGGGGTGGGCACCAGTA
ACATCACAGCTGCACGTCGAGAGTTACTCT|CGTTTATGCGATGCTAGTTCTATATCTGTC
CAGATTCGGTAATTGTTTCATACCTATATA|TCCGGCACATCTGGAGTACCAGAACACTAA
CGTCGGAAGTCTAATAAGCATCGGCAATCA|GGACCACTTAAGTAACTTACAGGTCGCCAA
AATCAACGTACTATCGGAAGTCTAATAAGC|AATCAACTTCGGAAGTCTAATAAGCATCGG
AGTCTAATAAGCATCGGCAATCAACCAACC|AACTAACAACATCTGCCGTTGGATGAACGG
TCGGCAATCAACCAAGTACCGCAAACCCCA|CGTCTCAAGTGTTAAGCTGGGCAGGCCTAT
CATCGGCAATCAACTCGGAAGTCTCGGAAG|GCATCGGCAATCAACGTTCGGAAGTCTAAT
TAATAAGCATCGGCAATCAACTTGGCTAAA|CCGAGAGTAGCCAAGGTTAGGGTGATGATG
AGGGTGATGATGAAGGTACAATCTCTCGTT|CCCACACAAGGTCGCACGGGAGTGCCCCAC
AGTTATTCTCTAATTAAGATGCACGCCCAA|TAGGATGAAGACGGGGACGGCGTTTACGTT
TAAGCGGTCACCTTTAAAGCGAGGACCTCT|GAAGTCTAATAAGCATCGGCAATCAACGTA
CTAAACCAATCTGAGTCAAACATCACAGCT|TGATGAAGGTACAATCTCTCGTTTATGCGA
GGGGTGGGCACCAGTAATTATGGATCGAAA|TGTGACTATAATTTCGATCTTCACTGAGCT
ATCACAGCTGCACGTCGAGAGTTACTCTGC|TTTATGCGATGCTAGTTCTATATCTGTCAG
GGAAGTCTAATAAGCATCGGCAATCAACGA|GGGGGAAGATGCGCTACATTTCGTACAAAG
CAATCAACCGGTAGGAAATCCGGCACATCT|CTCTTGTCGAATGTGCAAGATCGTAACGCT
CGCGTCGGAAGTCTAATAAGCATCGGCAAT|TTCTCGGGTGGCCCCGAGAGTAGCCAAGGT
CAAAAAAACAACATATTAGCAAGAAAGTAT|ATCAACTAATAAGCATCGGCAATCAACCGG
TCGGAAGTCTAATAAGCATCGGCAATCAAC|CGGGTGGCCCCGAGAGTAGCCAAGGTTAGG
CTAATAAGCATCGGCAATCAACTAACAACA|AAGCATCGGCAATCAACGACGCGTCCGATC
CCTGACACTTCTCGGGTGGCCCCGAGAGTA|AAGTCTAATAAGCATCGGCAATCAACGTTA
ACACTAACTCGGAAGTCTAATAAGCATCGG|ACTAAAATCGCCTTCACTGCTCAAAGCCTC
ACAGGCACTGCGCGTCGGAAGTCTAATAAG|TACCTGACACTTCTCGGGTGGCCCCGAGAG
TGGCCCCGAGAGTAGCCAAGGTTAGGGTGA|GGCAATCAACGTTATCGCCTGAGCCCACAC
GCAATCAACTTCGGAAGTCTAATAAGCATC|TTCTACATTGTAGGGGGAAGATGCGCTACA
GCCTGAGCCCACACAAGGTCGCACGGGAGT|CCTATATATCGGAAGTCTAATAAGCATCGG
CCAAGTACCGCAAACCCCACCTCTTGTCGA|TTAAGCTGGGCAGGCCTATAAGCGGTCACC
CTTCACTGCTCAAAGCCTCGGAAGTCTAAT|TTCGGAAGTCTAATAAGCATCGGCAATCAA
GCACTGCGCGTCGGAAGTCTAATAAGCATC|TGACACTTCTCGGGTGGCCCCGAGAGTAGC
AGATCGTAACGCTAATAAGGATCTACTAAA|CGAGGACCTCTCGGAAGTCTAATAAGCATC
TCTACATTGTAGGGGGAAGATGCGCTACAT|AGCTTTCCAAAATTTCCTGGGCGACCCGCT
ATAAGCATCGGCAATCAACTAACAACATCT|CATCGGCAATCAACGACGCGTCCGATCTGG
ATAAGGATCTACTAAAATCGCCTTCACTGC|AAGTCTAATAAGCATCGGCAATTCGGAAGT
GTAATTATGGATCGAAACCTGTCACTGCCA|TCGATCTTCACTGAGCTCACACGACATGTT
AAGCATCGGCAATCAACGTTCGGAAGTCTA|CAAAGCCTCGGAAGTCTAATAAGCATCGGC
CTCGGAAGTCTAATAAGCATCGGCAATCAA|AGTCTAATAAGCATCGGCAATCAACCAAGT
GGCACTGCGCGTCGGAAGTCTAATAAGCAT|CTGACACTTCTCGGGTGGCCCCGAGAGTAG
TAGCAAGAAAGTATGGACGATCAGATTCGG|CGGCAATCAACCGGTAGGAAATCCGGCACA
CGCCAATCGGAAGTCTAATAAGCATCGGCA|AGCAAGAAAGTATGGACGATCAGATTCGGT
CCAATCGGAAGTCTAATAAGCATCGGCAAT|CAAGAAAGTATGGACGATCAGATTCGGTAA
CATCTACGCTCTCAAGTCGGAAGTCTAATA|GCCAGTTATTCTCTAATTAAGATGCACGCC
TGTAGGGGGAAGATGCGCTACATTTCGTAC|CAAAATTTCCTGGGCGACCCGCTCCCCAAT
GGGAGTGCCCCACGGACACCGGTGGCACAC|CATCGGCAATCAACTCGGAAGTCTCGGAAG
TCTCTAATTAAGATGCACGCCCAAGGATTT|GAAGACGGGGACGGCGTTTACGTTCTTAAA
ACCAGTAATTATGGATCGAAACCTGTCACT|AATTTCGATCTTCACTGAGCTCACACGACA
GGAAGTCTAATAAGCATCGGCAATCAACTC|CGGAAGTCTAATAAGCATCGGCAATCAACG
CCACTTAAGTAACTTACAGGTCGCCAATCG|TGCGCAAAAAAACAACATATTAGCAAGAAA
ACTGGAGTAACATATGTATCATGTAGCGAC|CACTCGGCTCGGTCGTTCCATCTACGCTCT
CATCGGCAATCAACCAAGTACCGCAAACCC|ACCGTCTCAAGTGTTAAGCTGGGCAGGCCT
AATCAACCAAGTACCGCAAACCCCACCTCT|CAAGTGTTAAGCTGGGCAGGCCTATAAGCG
GTCTAATAAGCATCGGCAATCAACTAATAA|TAAGCATCGGCAATCAACCAAGTACCGCAA
TCTGGAGTACCAGAACACTAACTCGGAAGT|GCTAATAAGGATCTACTAAAATCGCCTTCA
ACCTTTAAAGCGAGGACCTCTCGGAAGTCT|TAAGCATCGGCAATCAACGTACTATCGGAA
ACTATCGGAAGTCTAATAAGCATCGGCAAT|CGGAAGTCTAATAAGCATCGGCAATCAACG
CAACGTATGCACTAAACTACGCTAACACGT|CACAGCTGCACGTCGAGAGTTACTCTGCGT
AGCATCGGCAATCAACGACGCGTCCGATCT|GCTACATTTCGTACAAAGGGAGATATAACA
ACTTCGGAAGTCTAATAAGCATCGGCAATC|TTGTAGGGGGAAGATGCGCTACATTTCGTA
TGTCAGGACCACTTAAGTAACTTACAGGTC|GAGTAATTTGCGCAAAAAAACAACATATTA
GCGTCGGAAGTCTAATAAGCATCGGCAATC|AGGACCACTTAAGTAACTTACAGGTCGCCA
GTCTAATAAGCATCGGCAATCAACTTGGCT|GCCCCGAGAGTAGCCAAGGTTAGGGTGATG
TCTGATTCCTCACAGGCACTGCGCGTCGGA|CGGCAATCAACTACCTGACACTTCTCGGGT
ACTACGCTAACACGTGGATAAAGGAGCGGT|AGAGTTACTCTGCGTCGGAAGTCTAATAAG
CACACTCTGGGAGTAATTTGCGCAAAAAAA|GGAAGTCTAATAAGCATCGGCAATCAACTA
TAAGCTGGGCAGGCCTATAAGCGGTCACCT|ATGTAGCGACACGCTCGGAAGTCTAATAAG
CAAGGTTAGGGTGATGATGAAGGTACAATC|GCCTGAGCCCACACAAGGTCGCACGGGAGT
AGGTCGCACGGGAGTGCCCCACGGACACCG|TCTAATAAGCATCGGCAATCAACTCGGAAG
TCTAATAAGCATCGGCAATCAACGACGCGT|AAGATGCGCTACATTTCGTACAAAGGGAGA
GCAATCAACCGTCTCAAGTGTTAAGCTGGG|GACTGGAGTAACATATGTATCATGTAGCGA
GTCTAATAAGCATCGGCAATCAACGTTATC|TGGACGATCAGATTCGGTAATTGTTTCATA
GCAATCAACGTTATCGCCTGAGCCCACACA|GGTAATTGTTTCATACCTATATATCGGAAG
AGTCTAATAAGCATCGGCAATCAACGTTAT|ATGGACGATCAGATTCGGTAATTGTTTCAT
CTCCACTGCGACTTTGACAACGTATGCACT|CAATCTGAGTCAAACATCACAGCTGCACGT
AACGTTATCGCCTGAGCCCACACAAGGTCG|TGTTTCATACCTATATATCGGAAGTCTAAT
AACTACCTGACACTTCTCGGGTGGCCCCGA|ATCGGAAGTCTAATAAGCATCGGCAATCAA
GAAACCTGTCACTGCCAGTTATTCTCTAAT|AGCTCACACGACATGTTAGGATGAAGACGG
TCAACTCGGAAGTCTCGGAAGTCTAATAAG|ATCAACGTTCGGAAGTCTAATAAGCATCGG
GACTGGAGTAACATATGTATCATGTAGCGA|TCACTCGGCTCGGTCGTTCCATCTACGCTC
CTAAACTACGCTAACACGTGGATAAAGGAG|GTCGAGAGTTACTCTGCGTCGGAAGTCTAA
TAATAAGCATCGGCAATCAACGACGCGTCC|GATGCGCTACATTTCGTACAAAGGGAGATA
CCTTTAAAGCGAGGACCTCTCGGAAGTCTA|AAGCATCGGCAATCAACGTACTATCGGAAG
AACATCTGCCGTTGGATGAACGGTGTCACT|GATCTGGGGTGGGCACCAGTAATTATGGAT
TGCGCGTCGGAAGTCTAATAAGCATCGGCA|ACTTCTCGGGTGGCCCCGAGAGTAGCCAAG
TCAAGTCGGAAGTCTAATAAGCATCGGCAA|TCTAATTAAGATGCACGCCCAAGGATTTCT
ATATCGGAAGTCTAATAAGCATCGGCAATC|TAACTCGGAAGTCTAATAAGCATCGGCAAT
GTTCTATATCTGTCAGGACCACTTAAGTAA|CACACTCTGGGAGTAATTTGCGCAAAAAAA
GAGTAACATATGTATCATGTAGCGACACGC|CGGCTCGGTCGTTCCATCTACGCTCTCAAG
ACTCGGCTCGGTCGTTCCATCTACGCTCTC|GATCGAAACCTGTCACTGCCAGTTATTCTC
AATAAGCATCGGCAATCAACGACGCGTCCG|ATGCGCTACATTTCGTACAAAGGGAGATAT
AGGACCACTTAAGTAACTTACAGGTCGCCA|AATTTGCGCAAAAAAACAACATATTAGCAA
ATCTCTCGTTTATGCGATGCTAGTTCTATA|AGTGCCCCACGGACACCGGTGGCACACTCT
TGTCGAATGTGCAAGATCGTAACGCTAATA|GTCACCTTTAAAGCGAGGACCTCTCGGAAG
GACACGCTCGGAAGTCTAATAAGCATCGGC|TCTCAAGTCGGAAGTCTAATAAGCATCGGC
CCCGACTGGAGTAACATATGTATCATGTAG|GTGTCACTCGGCTCGGTCGTTCCATCTACG
TGAGTCAAACATCACAGCTGCACGTCGAGA|CAATCTCTCGTTTATGCGATGCTAGTTCTA
AGAGTTACTCTGCGTCGGAAGTCTAATAAG|CTATATCTGTCAGGACCACTTAAGTAACTT
TCTAATAAGCATCGGCAATCAACGTTATCG|GGACGATCAGATTCGGTAATTGTTTCATAC
GTCTAATAAGCATCGGCAATCAACCAACCC|ACTAACAACATCTGCCGTTGGATGAACGGT
AGTCTAATAAGCATCGGCAATCAACTAATA|ATAAGCATCGGCAATCAACCAAGTACCGCA
CGGACACCGGTGGCACACTCTGGGAGTAAT|ACTCGGAAGTCTCGGAAGTCTAATAAGCAT
AATCGCCTTCACTGCTCAAAGCCTCGGAAG|CGGCAATTCGGAAGTCTAATAAGCATCGGC
GTTGGATGAACGGTGTCACTCGGCTCGGTC|GGGCACCAGTAATTATGGATCGAAACCTGT
TCGGAAGTCTAATAAGCATCGGCAATCAAC|AGTCTAATAAGCATCGGCAATCAACGACGC
AGCATCGGCAATCAACCAAGTACCGCAAAC|CAACCGTCTCAAGTGTTAAGCTGGGCAGGC
AACGACGCGTCCGATCTGGGGTGGGCACCA|CAAAGGGAGATATAACATGTGACTATAATT
GCATCGGCAATCAACTAACAACATCTGCCG|GGCAATCAACGACGCGTCCGATCTGGGGTG
AGCATCGGCAATCAACTTGGCTAAACCAAT|AGTAGCCAAGGTTAGGGTGATGATGAAGGT
GTGATGATGAAGGTACAATCTCTCGTTTAT|ACACAAGGTCGCACGGGAGTGCCCCACGGA
ACTAATAAGCATCGGCAATCAACCGGTAGG|TACCGCAAACCCCACCTCTTGTCGAATGTG
TAGTTCTATATCTGTCAGGACCACTTAAGT|GGCACACTCTGGGAGTAATTTGCGCAAAAA
AGTCTAATAAGCATCGGCAATCAACGTTCG|TCACTGCTCAAAGCCTCGGAAGTCTAATAA
TCTGGGAGTAATTTGCGCAAAAAAACAACA|TCTAATAAGCATCGGCAATCAACTAATAAG
TCAACGACGCGTCCGATCTGGGGTGGGCAC|TACAAAGGGAGATATAACATGTGACTATAA
CACTGCGCGTCGGAAGTCTAATAAGCATCG|GACACTTCTCGGGTGGCCCCGAGAGTAGCC
TCGGCAATCAACTACCTGACACTTCTCGGG|AGGTCGCCAATCGGAAGTCTAATAAGCATC
GCAAGAAAGTATGGACGATCAGATTCGGTA|GCAATCAACCGGTAGGAAATCCGGCACATC
GTCAAACATCACAGCTGCACGTCGAGAGTT|TCTCTCGTTTATGCGATGCTAGTTCTATAT
CGGAAGTCTAATAAGCATCGGCAATCAACT|TAAGATGCACGCCCAAGGATTTCTACATTG
AGTCTAATAAGCATCGGCAATCAACGACGC|GGAAGATGCGCTACATTTCGTACAAAGGGA
CAACATATTAGCAAGAAAGTATGGACGATC|ATAAGCATCGGCAATCAACCGGTAGGAAAT
TGGACGATCAGATTCGGTAATTGTTTCATA|GTAGGAAATCCGGCACATCTGGAGTACCAG
AGGGGGAAGATGCGCTACATTTCGTACAAA|AATTTCCTGGGCGACCCGCTCCCCAATAAG
CGGAAGTCTAATAAGCATCGGCAATCAACT|CCACTTAAGTAACTTACAGGTCGCCAATCG
TCTTGTCGAATGTGCAAGATCGTAACGCTA|GCGGTCACCTTTAAAGCGAGGACCTCTCGG
ATAAGCATCGGCAATCAACTAATAAGCATC|ATCGGCAATCAACCAAGTACCGCAAACCCC
GGAAGTCTAATAAGCATCGGCAATCAACGT|CCTTCACTGCTCAAAGCCTCGGAAGTCTAA
CAACTAATAAGCATCGGCAATCAACCGGTA|AGTACCGCAAACCCCACCTCTTGTCGAATG
ACGTCGAGAGTTACTCTGCGTCGGAAGTCT|CTAGTTCTATATCTGTCAGGACCACTTAAG
TGCACGCCCAAGGATTTCTACATTGTAGGG|GCGTTTACGTTCTTAAAGCTTTCCAAAATT
AATAAGCATCGGCAATCAACCAACCCCGAC|ACAACATCTGCCGTTGGATGAACGGTGTCA
TTCTATATCTGTCAGGACCACTTAAGTAAC|ACACTCTGGGAGTAATTTGCGCAAAAAAAC
ATATCTGTCAGGACCACTTAAGTAACTTAC|TCTGGGAGTAATTTGCGCAAAAAAACAACA
ATAAGCGGTCACCTTTAAAGCGAGGACCTC|GGAAGTCTAATAAGCATCGGCAATCAACGT
ATGCGCTACATTTCGTACAAAGGGAGATAT|GGCGACCCGCTCCCCAATAAGGTCTTGATG
TTAAGTAACTTACAGGTCGCCAATCGGAAG|CAAAAAAACAACATATTAGCAAGAAAGTAT
TGCCGTTGGATGAACGGTGTCACTCGGCTC|GGGTGGGCACCAGTAATTATGGATCGAAAC
AAGATCGTAACGCTAATAAGGATCTACTAA|GCGAGGACCTCTCGGAAGTCTAATAAGCAT
ATCGGCAATCAACCAAGTACCGCAAACCCC|CCGTCTCAAGTGTTAAGCTGGGCAGGCCTA
CATCGGCAATCAACCAACCCCGACTGGAGT|TCTGCCGTTGGATGAACGGTGTCACTCGGC
TCTGTCAGGACCACTTAAGTAACTTACAGG|GGGAGTAATTTGCGCAAAAAAACAACATAT
CTAATAAGCATCGGCAATCAACCAACCCCG|TAACAACATCTGCCGTTGGATGAACGGTGT
TCTAATAAGCATCGGCAATTCGGAAGTCTA|GAAGTCTAATAAGCATCGGCAATCAACTAA
CTTGGCTAAACCAATCTGAGTCAAACATCA|GGTGATGATGAAGGTACAATCTCTCGTTTA
GGAAGTCTAATAAGCATCGGCAATCAACCG|TCGGCAATCAACCAACCCCGACTGGAGTAA
CGACTTTGACAACGTATGCACTAAACTACG|GTCAAACATCACAGCTGCACGTCGAGAGTT
GGAAGTCTAATAAGCATCGGCAATCAACTA|CACTTAAGTAACTTACAGGTCGCCAATCGG
TACAGGTCGCCAATCGGAAGTCTAATAAGC|ACATATTAGCAAGAAAGTATGGACGATCAG
GAAGTCTAATAAGCATCGGCAATCAACGTA|GAAGTCTAATAAGCATCGGCAATCAACTTC
ATCAACTTGGCTAAACCAATCTGAGTCAAA|GTTAGGGTGATGATGAAGGTACAATCTCTC
CTGGAGTAACATATGTATCATGTAGCGACA|ACTCGGCTCGGTCGTTCCATCTACGCTCTC
GTCGGAAGTCTAATAAGCATCGGCAATCAA|TCGGGTGGCCCCGAGAGTAGCCAAGGTTAG
CTAATTAAGATGCACGCCCAAGGATTTCTA|GACGGGGACGGCGTTTACGTTCTTAAAGCT
GGCAATCAACCAACCCCGACTGGAGTAACA|CCGTTGGATGAACGGTGTCACTCGGCTCGG
AAGCATCGGCAATCAACGTTATCGCCTGAG|TCAGATTCGGTAATTGTTTCATACCTATAT
AACCAATCTGAGTCAAACATCACAGCTGCA|TGAAGGTACAATCTCTCGTTTATGCGATGC
CGGCACATCTGGAGTACCAGAACACTAACT|TCGTAACGCTAATAAGGATCTACTAAAATC
AAGAAAGTATGGACGATCAGATTCGGTAAT|AATCAACCGGTAGGAAATCCGGCACATCTG
CTCTAATTAAGATGCACGCCCAAGGATTTC|AAGACGGGGACGGCGTTTACGTTCTTAAAG
CTCTCGGAAGTCTAATAAGCATCGGCAATT|CGTACTATCGGAAGTCTAATAAGCATCGGC
GCGCAAAAAAACAACATATTAGCAAGAAAG|GCAATCAACTAATAAGCATCGGCAATCAAC
AACCGGTAGGAAATCCGGCACATCTGGAGT|GTCGAATGTGCAAGATCGTAACGCTAATAA
GAAGTCTAATAAGCATCGGCAATCAACGTT|GTATGGACGATCAGATTCGGTAATTGTTTC
AAAACAACATATTAGCAAGAAAGTATGGAC|ACTAATAAGCATCGGCAATCAACCGGTAGG
TGCGATGCTAGTTCTATATCTGTCAGGACC|ACACCGGTGGCACACTCTGGGAGTAATTTG
GAAGTCTAATAAGCATCGGCAATCAACCAA|GCATCGGCAATCAACCGTCTCAAGTGTTAA
AGTCAAACATCACAGCTGCACGTCGAGAGT|ATCTCTCGTTTATGCGATGCTAGTTCTATA
TAATAAGCATCGGCAATCAACCAACCCCGA|AACAACATCTGCCGTTGGATGAACGGTGTC
CGGAAGTCTAATAAGCATCGGCAATCAACG|AAGTATGGACGATCAGATTCGGTAATTGTT
CTAGTTCTATATCTGTCAGGACCACTTAAG|TGGCACACTCTGGGAGTAATTTGCGCAAAA
CACGCTCGGAAGTCTAATAAGCATCGGCAA|TCAAGTCGGAAGTCTAATAAGCATCGGCAA
CAACCGTCTCAAGTGTTAAGCTGGGCAGGC|GAGTAACATATGTATCATGTAGCGACACGC
CAAGTGTTAAGCTGGGCAGGCCTATAAGCG|ATGTATCATGTAGCGACACGCTCGGAAGTC
GATGCTAGTTCTATATCTGTCAGGACCACT|CCGGTGGCACACTCTGGGAGTAATTTGCGC
TCCTCACAGGCACTGCGCGTCGGAAGTCTA|TCAACTACCTGACACTTCTCGGGTGGCCCC
GGCAATCAACTCGGAAGTCTCGGAAGTCTA|CGGCAATCAACGTTCGGAAGTCTAATAAGC
CACAAGGTCGCACGGGAGTGCCCCACGGAC|GAAGTCTAATAAGCATCGGCAATCAACTCG
ATAAGCATCGGCAATCAACGACGCGTCCGA|TGCGCTACATTTCGTACAAAGGGAGATATA
ATCTACGCTCTCAAGTCGGAAGTCTAATAA|CCAGTTATTCTCTAATTAAGATGCACGCCC
ACGTTCGGAAGTCTAATAAGCATCGGCAAT|CTAATAAGCATCGGCAATCAACCGTCTCAA
GAACTCCACTGCGACTTTGACAACGTATGC|AACCAATCTGAGTCAAACATCACAGCTGCA
TCGGCAATCAACCGTCTCAAGTGTTAAGCT|CCCGACTGGAGTAACATATGTATCATGTAG
GGCAATCAACTACCTGACACTTCTCGGGTG|GTCGCCAATCGGAAGTCTAATAAGCATCGG
TTCACTGCTCAAAGCCTCGGAAGTCTAATA|TCGGAAGTCTAATAAGCATCGGCAATCAAC
TAAGCATCGGCAATCAACTTCGGAAGTCTA|CCCAAGGATTTCTACATTGTAGGGGGAAGA
TCGGCAATCAACCAACCCCGACTGGAGTAA|TGCCGTTGGATGAACGGTGTCACTCGGCTC
ATTAGCAAGAAAGTATGGACGATCAGATTC|ATCGGCAATCAACCGGTAGGAAATCCGGCA
TCGGCAATCAACCGGTAGGAAATCCGGCAC|CCACCTCTTGTCGAATGTGCAAGATCGTAA
GGGCACCAGTAATTATGGATCGAAACCTGT|CTATAATTTCGATCTTCACTGAGCTCACAC
CTAATAAGCATCGGCAATCAACTTGGCTAA|CCCGAGAGTAGCCAAGGTTAGGGTGATGAT
GGACCACTTAAGTAACTTACAGGTCGCCAA|ATTTGCGCAAAAAAACAACATATTAGCAAG
ATCTGTCAGGACCACTTAAGTAACTTACAG|TGGGAGTAATTTGCGCAAAAAAACAACATA
AGCTGGGCAGGCCTATAAGCGGTCACCTTT|GTAGCGACACGCTCGGAAGTCTAATAAGCA
GGCAATCAACTAATAAGCATCGGCAATCAA|CAACCAAGTACCGCAAACCCCACCTCTTGT
GTCGAATGTGCAAGATCGTAACGCTAATAA|TCACCTTTAAAGCGAGGACCTCTCGGAAGT
CTTAAGTAACTTACAGGTCGCCAATCGGAA|GCAAAAAAACAACATATTAGCAAGAAAGTA
CCAATCTGAGTCAAACATCACAGCTGCACG|AAGGTACAATCTCTCGTTTATGCGATGCTA
GGTCGCACGGGAGTGCCCCACGGACACCGG|CTAATAAGCATCGGCAATCAACTCGGAAGT
GCATCGGCAATCAACTTCGGAAGTCTAATA|AAGGATTTCTACATTGTAGGGGGAAGATGC
CATCGGCAATCAACTAATAAGCATCGGCAA|CAATCAACCAAGTACCGCAAACCCCACCTC
CGGAAGTCTAATAAGCATCGGCAATCAACT|TCTAATAAGCATCGGCAATCAACCAAGTAC
AGTCTAATAAGCATCGGCAATCAACGTACT|AGTCTAATAAGCATCGGCAATCAACTTCGG
GCAATCAACCGGTAGGAAATCCGGCACATC|CCTCTTGTCGAATGTGCAAGATCGTAACGC
ATGTAGCGACACGCTCGGAAGTCTAATAAG|TCTACGCTCTCAAGTCGGAAGTCTAATAAG
TGCGACTTTGACAACGTATGCACTAAACTA|GAGTCAAACATCACAGCTGCACGTCGAGAG
ACTTACAGGTCGCCAATCGGAAGTCTAATA|ACAACATATTAGCAAGAAAGTATGGACGAT
TCTAATAAGCATCGGCAATCAACTAACAAC|TAAGCATCGGCAATCAACGACGCGTCCGAT
GTGCCCCACGGACACCGGTGGCACACTCTG|GGCAATCAACTCGGAAGTCTCGGAAGTCTA
ACTGCGACTTTGACAACGTATGCACTAAAC|CTGAGTCAAACATCACAGCTGCACGTCGAG
TAATAAGCATCGGCAATCAACCGGTAGGAA|CCGCAAACCCCACCTCTTGTCGAATGTGCA
TCGGCAATCAACTTCGGAAGTCTAATAAGC|GATTTCTACATTGTAGGGGGAAGATGCGCT
CCTGAGCCCACACAAGGTCGCACGGGAGTG|CTATATATCGGAAGTCTAATAAGCATCGGC
GGATAAAGGAGCGGTCAATCTGATTCCTCA|CGGAAGTCTAATAAGCATCGGCAATCAACT
CAATCAACCAAGTACCGCAAACCCCACCTC|TCAAGTGTTAAGCTGGGCAGGCCTATAAGC
ATCAACTACCTGACACTTCTCGGGTGGCCC|CCAATCGGAAGTCTAATAAGCATCGGCAAT
GTAGCCAAGGTTAGGGTGATGATGAAGGTA|TTATCGCCTGAGCCCACACAAGGTCGCACG
ATCGGCAATCAACCGTCTCAAGTGTTAAGC|CCCCGACTGGAGTAACATATGTATCATGTA
TCGGTCGTTCCATCTACGCTCTCAAGTCGG|ACCTGTCACTGCCAGTTATTCTCTAATTAA
GATGAAGGTACAATCTCTCGTTTATGCGAT|AGGTCGCACGGGAGTGCCCCACGGACACCG
CAAGTACCGCAAACCCCACCTCTTGTCGAA|TAAGCTGGGCAGGCCTATAAGCGGTCACCT
GAAGTCTAATAAGCATCGGCAATCAACCGT|CGGCAATCAACCAACCCCGACTGGAGTAAC
CCACGGACACCGGTGGCACACTCTGGGAGT|TCAACTCGGAAGTCTCGGAAGTCTAATAAG
GGAAGTCTAATAAGCATCGGCAATCAACGT|GGAAGTCTAATAAGCATCGGCAATCAACTT
ACAAGGTCGCACGGGAGTGCCCCACGGACA|AAGTCTAATAAGCATCGGCAATCAACTCGG
CATCGGCAATCAACTACCTGACACTTCTCG|ACAGGTCGCCAATCGGAAGTCTAATAAGCA
GGCACACTCTGGGAGTAATTTGCGCAAAAA|TCGGAAGTCTAATAAGCATCGGCAATCAAC
TTTGCGCAAAAAAACAACATATTAGCAAGA|TCGGCAATCAACTAATAAGCATCGGCAATC
GTCTAATAAGCATCGGCAATCAACTAACAA|ATAAGCATCGGCAATCAACGACGCGTCCGA
TCAACTTGGCTAAACCAATCTGAGTCAAAC|TTAGGGTGATGATGAAGGTACAATCTCTCG
CGCTCTCAAGTCGGAAGTCTAATAAGCATC|TATTCTCTAATTAAGATGCACGCCCAAGGA
GCAATCAACGTTCGGAAGTCTAATAAGCAT|CGGAAGTCTAATAAGCATCGGCAATCAACC
TCCATCTACGCTCTCAAGTCGGAAGTCTAA|CTGCCAGTTATTCTCTAATTAAGATGCACG
TCAACGTTCGGAAGTCTAATAAGCATCGGC|AGTCTAATAAGCATCGGCAATCAACCGTCT
TACGCTCTCAAGTCGGAAGTCTAATAAGCA|GTTATTCTCTAATTAAGATGCACGCCCAAG
TAAGCATCGGCAATCAACTTGGCTAAACCA|AGAGTAGCCAAGGTTAGGGTGATGATGAAG
CCGGTAGGAAATCCGGCACATCTGGAGTAC|CGAATGTGCAAGATCGTAACGCTAATAAGG
TCAGGACCACTTAAGTAACTTACAGGTCGC|GTAATTTGCGCAAAAAAACAACATATTAGC
CTATATCTGTCAGGACCACTTAAGTAACTT|ACTCTGGGAGTAATTTGCGCAAAAAAACAA
GATCTACTAAAATCGCCTTCACTGCTCAAA|TAATAAGCATCGGCAATTCGGAAGTCTAAT
TCGCCTTCACTGCTCAAAGCCTCGGAAGTC|GCAATTCGGAAGTCTAATAAGCATCGGCAA
ATCTGGGGTGGGCACCAGTAATTATGGATC|AACATGTGACTATAATTTCGATCTTCACTG
ATAAGCATCGGCAATCAACCAAGTACCGCA|AATCAACCGTCTCAAGTGTTAAGCTGGGCA
ACGGACACCGGTGGCACACTCTGGGAGTAA|AACTCGGAAGTCTCGGAAGTCTAATAAGCA
TCTACTAAAATCGCCTTCACTGCTCAAAGC|ATAAGCATCGGCAATTCGGAAGTCTAATAA
AATTAAGATGCACGCCCAAGGATTTCTACA|CGGGGACGGCGTTTACGTTCTTAAAGCTTT
GCACACTCTGGGAGTAATTTGCGCAAAAAA|CGGAAGTCTAATAAGCATCGGCAATCAACT
CCAGTAATTATGGATCGAAACCTGTCACTG|ATTTCGATCTTCACTGAGCTCACACGACAT
TAAGCATCGGCAATCAACCAAGTACCGCAA|ATCAACCGTCTCAAGTGTTAAGCTGGGCAG
CGGGTGGCCCCGAGAGTAGCCAAGGTTAGG|CATCGGCAATCAACGTTATCGCCTGAGCCC
TCGGAAGTCTAATAAGCATCGGCAATCAAC|TAGGGGGAAGATGCGCTACATTTCGTACAA
AGCATCGGCAATCAACGTTATCGCCTGAGC|CAGATTCGGTAATTGTTTCATACCTATATA
CATATGTATCATGTAGCGACACGCTCGGAA|GGTCGTTCCATCTACGCTCTCAAGTCGGAA
AGCATCGGCAATCAACTACCTGACACTTCT|TTACAGGTCGCCAATCGGAAGTCTAATAAG
CATCGGCAATCAACTAACAACATCTGCCGT|GCAATCAACGACGCGTCCGATCTGGGGTGG
ACGCTCGGAAGTCTAATAAGCATCGGCAAT|CAAGTCGGAAGTCTAATAAGCATCGGCAAT
GTAGGAAATCCGGCACATCTGGAGTACCAG|ATGTGCAAGATCGTAACGCTAATAAGGATC
ACCTGACACTTCTCGGGTGGCCCCGAGAGT|GAAGTCTAATAAGCATCGGCAATCAACGTT
AAGTAACTTACAGGTCGCCAATCGGAAGTC|AAAAAACAACATATTAGCAAGAAAGTATGG
ATAAGCATCGGCAATCAACCGTCTCAAGTG|AACCAACCCCGACTGGAGTAACATATGTAT
AGTCTAATAAGCATCGGCAATCAACCAAGT|ATCGGCAATCAACCGTCTCAAGTGTTAAGC
GAAGTCTAATAAGCATCGGCAATCAACTAA|CTAATAAGCATCGGCAATCAACGACGCGTC
GAGTAGCCAAGGTTAGGGTGATGATGAAGG|CGTTATCGCCTGAGCCCACACAAGGTCGCA
TATGCGATGCTAGTTCTATATCTGTCAGGA|GGACACCGGTGGCACACTCTGGGAGTAATT
CAATCAACTTCGGAAGTCTAATAAGCATCG|TCTACATTGTAGGGGGAAGATGCGCTACAT
TTATGGATCGAAACCTGTCACTGCCAGTTA|TCTTCACTGAGCTCACACGACATGTTAGGA
CCTTCACTGCTCAAAGCCTCGGAAGTCTAA|ATTCGGAAGTCTAATAAGCATCGGCAATCA
CACCGGTGGCACACTCTGGGAGTAATTTGC|GGAAGTCTCGGAAGTCTAATAAGCATCGGC
AGGTTAGGGTGATGATGAAGGTACAATCTC|CTGAGCCCACACAAGGTCGCACGGGAGTGC
TCAAACATCACAGCTGCACGTCGAGAGTTA|CTCTCGTTTATGCGATGCTAGTTCTATATC
TACTAAAATCGCCTTCACTGCTCAAAGCCT|AAGCATCGGCAATTCGGAAGTCTAATAAGC
TAATTTGCGCAAAAAAACAACATATTAGCA|GCATCGGCAATCAACTAATAAGCATCGGCA
CTCGGTCGTTCCATCTACGCTCTCAAGTCG|AACCTGTCACTGCCAGTTATTCTCTAATTA
AAGCTGGGCAGGCCTATAAGCGGTCACCTT|TGTAGCGACACGCTCGGAAGTCTAATAAGC
ATCTGGAGTACCAGAACACTAACTCGGAAG|CGCTAATAAGGATCTACTAAAATCGCCTTC
ACCACTTAAGTAACTTACAGGTCGCCAATC|TTGCGCAAAAAAACAACATATTAGCAAGAA
CTAATAAGCATCGGCAATCAACGACGCGTC|AGATGCGCTACATTTCGTACAAAGGGAGAT
GTTATTCTCTAATTAAGATGCACGCCCAAG|AGGATGAAGACGGGGACGGCGTTTACGTTC
ATTAAGATGCACGCCCAAGGATTTCTACAT|GGGGACGGCGTTTACGTTCTTAAAGCTTTC
CTAATAAGCATCGGCAATCAACCAAGTACC|GGCAATCAACCGTCTCAAGTGTTAAGCTGG
GGAAATCCGGCACATCTGGAGTACCAGAAC|TGCAAGATCGTAACGCTAATAAGGATCTAC
ATCGGAAGTCTAATAAGCATCGGCAATCAA|ACTCGGAAGTCTAATAAGCATCGGCAATCA
TCTAATAAGCATCGGCAATCAACGTACTAT|TCTAATAAGCATCGGCAATCAACTTCGGAA
TTGTCGAATGTGCAAGATCGTAACGCTAAT|GGTCACCTTTAAAGCGAGGACCTCTCGGAA
AGGTACAATCTCTCGTTTATGCGATGCTAG|GCACGGGAGTGCCCCACGGACACCGGTGGC
AACGTATGCACTAAACTACGCTAACACGTG|ACAGCTGCACGTCGAGAGTTACTCTGCGTC
AATGTGCAAGATCGTAACGCTAATAAGGAT|CTTTAAAGCGAGGACCTCTCGGAAGTCTAA
CAAAGCCTCGGAAGTCTAATAAGCATCGGC|TAATAAGCATCGGCAATCAACCAACCCCGA
TAACTCGGAAGTCTAATAAGCATCGGCAAT|AAATCGCCTTCACTGCTCAAAGCCTCGGAA
GCAATCAACCAACCCCGACTGGAGTAACAT|CGTTGGATGAACGGTGTCACTCGGCTCGGT
CAAGTCGGAAGTCTAATAAGCATCGGCAAT|CTAATTAAGATGCACGCCCAAGGATTTCTA
ATAAGCATCGGCAATCAACGTACTATCGGA|ATAAGCATCGGCAATCAACTTCGGAAGTCT
GTCTAATAAGCATCGGCAATCAACCAAGTA|TCGGCAATCAACCGTCTCAAGTGTTAAGCT
TCGGCAATCAACTTGGCTAAACCAATCTGA|GCCAAGGTTAGGGTGATGATGAAGGTACAA
GTGCAAGATCGTAACGCTAATAAGGATCTA|TAAAGCGAGGACCTCTCGGAAGTCTAATAA
TCGGCAATCAACGTTCGGAAGTCTAATAAG|CCTCGGAAGTCTAATAAGCATCGGCAATCA
ATCGGCAATCAACGTACTATCGGAAGTCTA|ATCGGCAATCAACTTCGGAAGTCTAATAAG
GGAGTACCAGAACACTAACTCGGAAGTCTA|AATAAGGATCTACTAAAATCGCCTTCACTG
ATCTACTAAAATCGCCTTCACTGCTCAAAG|AATAAGCATCGGCAATTCGGAAGTCTAATA
CGACTGGAGTAACATATGTATCATGTAGCG|GTCACTCGGCTCGGTCGTTCCATCTACGCT
GTCACTCGGCTCGGTCGTTCCATCTACGCT|ATGGATCGAAACCTGTCACTGCCAGTTATT
AGCATCGGCAATCAACGTACTATCGGAAGT|AGCATCGGCAATCAACTTCGGAAGTCTAAT
GCCTATAAGCGGTCACCTTTAAAGCGAGGA|GCTCGGAAGTCTAATAAGCATCGGCAATCA
TTTATGCGATGCTAGTTCTATATCTGTCAG|ACGGACACCGGTGGCACACTCTGGGAGTAA
CTGCCGTTGGATGAACGGTGTCACTCGGCT|GGGGTGGGCACCAGTAATTATGGATCGAAA
CAATCAACTAACAACATCTGCCGTTGGATG|AACGACGCGTCCGATCTGGGGTGGGCACCA
AATTGTTTCATACCTATATATCGGAAGTCT|CTGGAGTACCAGAACACTAACTCGGAAGTC
TATAAGCGGTCACCTTTAAAGCGAGGACCT|CGGAAGTCTAATAAGCATCGGCAATCAACG
GCAATCAACGTACTATCGGAAGTCTAATAA|GCAATCAACTTCGGAAGTCTAATAAGCATC
GTCTAATAAGCATCGGCAATTCGGAAGTCT|GGAAGTCTAATAAGCATCGGCAATCAACTA
GACTTTGACAACGTATGCACTAAACTACGC|TCAAACATCACAGCTGCACGTCGAGAGTTA
AATCTGATTCCTCACAGGCACTGCGCGTCG|ATCGGCAATCAACTACCTGACACTTCTCGG
GCGTCCGATCTGGGGTGGGCACCAGTAATT|GAGATATAACATGTGACTATAATTTCGATC
AAACCTGTCACTGCCAGTTATTCTCTAATT|GCTCACACGACATGTTAGGATGAAGACGGG
TGCCAGTTATTCTCTAATTAAGATGCACGC|ATGTTAGGATGAAGACGGGGACGGCGTTTA
GTACCAGAACACTAACTCGGAAGTCTAATA|AAGGATCTACTAAAATCGCCTTCACTGCTC
TTCCTCACAGGCACTGCGCGTCGGAAGTCT|ATCAACTACCTGACACTTCTCGGGTGGCCC
ACATTTCGTACAAAGGGAGATATAACATGT|CGCTCCCCAATAAGGTCTTGATGCGGGTCT
TCTCGGGTGGCCCCGAGAGTAGCCAAGGTT|AAGCATCGGCAATCAACGTTATCGCCTGAG
GCCAATCGGAAGTCTAATAAGCATCGGCAA|GCAAGAAAGTATGGACGATCAGATTCGGTA
ACGTGGATAAAGGAGCGGTCAATCTGATTC|GCGTCGGAAGTCTAATAAGCATCGGCAATC
AAGTCTAATAAGCATCGGCAATCAACTCGG|GAAGTCTAATAAGCATCGGCAATCAACGTT
GCATCGGCAATCAACTAATAAGCATCGGCA|GCAATCAACCAAGTACCGCAAACCCCACCT
GGCAATCAACCGGTAGGAAATCCGGCACAT|ACCTCTTGTCGAATGTGCAAGATCGTAACG
TATGTATCATGTAGCGACACGCTCGGAAGT|TCGTTCCATCTACGCTCTCAAGTCGGAAGT
CATACCTATATATCGGAAGTCTAATAAGCA|CCAGAACACTAACTCGGAAGTCTAATAAGC
CTCGGAAGTCTAATAAGCATCGGCAATCAA|GTCGGAAGTCTAATAAGCATCGGCAATCAA
GGCTCGGTCGTTCCATCTACGCTCTCAAGT|GAAACCTGTCACTGCCAGTTATTCTCTAAT
CAATCTCTCGTTTATGCGATGCTAGTTCTA|GGAGTGCCCCACGGACACCGGTGGCACACT
TCTAATAAGCATCGGCAATCAACTTCGGAA|GCACGCCCAAGGATTTCTACATTGTAGGGG
ACTCTGGGAGTAATTTGCGCAAAAAAACAA|AGTCTAATAAGCATCGGCAATCAACTAATA
CAAGGATTTCTACATTGTAGGGGGAAGATG|GTTCTTAAAGCTTTCCAAAATTTCCTGGGC
CATCGGCAATTCGGAAGTCTAATAAGCATC|TAAGCATCGGCAATCAACTAACAACATCTG
GATTTCTACATTGTAGGGGGAAGATGCGCT|TTAAAGCTTTCCAAAATTTCCTGGGCGACC
GGTGATGATGAAGGTACAATCTCTCGTTTA|CACACAAGGTCGCACGGGAGTGCCCCACGG
GATCAGATTCGGTAATTGTTTCATACCTAT|AAATCCGGCACATCTGGAGTACCAGAACAC
CGGCAATTCGGAAGTCTAATAAGCATCGGC|GCATCGGCAATCAACTAACAACATCTGCCG
ATTTGCGCAAAAAAACAACATATTAGCAAG|ATCGGCAATCAACTAATAAGCATCGGCAAT
TTCGGTAATTGTTTCATACCTATATATCGG|GCACATCTGGAGTACCAGAACACTAACTCG
ACCGGTAGGAAATCCGGCACATCTGGAGTA|TCGAATGTGCAAGATCGTAACGCTAATAAG
TAGGGTGATGATGAAGGTACAATCTCTCGT|GCCCACACAAGGTCGCACGGGAGTGCCCCA
ACTGCTCAAAGCCTCGGAAGTCTAATAAGC|GAAGTCTAATAAGCATCGGCAATCAACCAA
TGGCTAAACCAATCTGAGTCAAACATCACA|TGATGATGAAGGTACAATCTCTCGTTTATG
CCAGTTATTCTCTAATTAAGATGCACGCCC|GTTAGGATGAAGACGGGGACGGCGTTTACG
CTCGGGTGGCCCCGAGAGTAGCCAAGGTTA|AGCATCGGCAATCAACGTTATCGCCTGAGC
CTCAAAGCCTCGGAAGTCTAATAAGCATCG|TCTAATAAGCATCGGCAATCAACCAACCCC
GCGAGGACCTCTCGGAAGTCTAATAAGCAT|GCAATCAACGTACTATCGGAAGTCTAATAA
AATTTGCGCAAAAAAACAACATATTAGCAA|CATCGGCAATCAACTAATAAGCATCGGCAA
GTTCCATCTACGCTCTCAAGTCGGAAGTCT|CACTGCCAGTTATTCTCTAATTAAGATGCA
AGCAAGAAAGTATGGACGATCAGATTCGGT|GGCAATCAACCGGTAGGAAATCCGGCACAT
TAAACTACGCTAACACGTGGATAAAGGAGC|TCGAGAGTTACTCTGCGTCGGAAGTCTAAT
CGGCAATCAACGTTCGGAAGTCTAATAAGC|CTCGGAAGTCTAATAAGCATCGGCAATCAA
ACCAATCTGAGTCAAACATCACAGCTGCAC|GAAGGTACAATCTCTCGTTTATGCGATGCT
TCATACCTATATATCGGAAGTCTAATAAGC|ACCAGAACACTAACTCGGAAGTCTAATAAG
AAGTACCGCAAACCCCACCTCTTGTCGAAT|AAGCTGGGCAGGCCTATAAGCGGTCACCTT
TCTGCCGTTGGATGAACGGTGTCACTCGGC|TGGGGTGGGCACCAGTAATTATGGATCGAA
TCTAATAAGCATCGGCAATCAACCAACCCC|CTAACAACATCTGCCGTTGGATGAACGGTG
AACTCCACTGCGACTTTGACAACGTATGCA|ACCAATCTGAGTCAAACATCACAGCTGCAC
TAATTATGGATCGAAACCTGTCACTGCCAG|CGATCTTCACTGAGCTCACACGACATGTTA
CGGCAATCAACTTCGGAAGTCTAATAAGCA|ATTTCTACATTGTAGGGGGAAGATGCGCTA
CGGCAATCAACCAACCCCGACTGGAGTAAC|GCCGTTGGATGAACGGTGTCACTCGGCTCG
GCATCGGCAATCAACTCGGAAGTCTCGGAA|AGCATCGGCAATCAACGTTCGGAAGTCTAA
AAGCATCGGCAATCAACTACCTGACACTTC|CTTACAGGTCGCCAATCGGAAGTCTAATAA
CTAATAAGCATCGGCAATCAACGTACTATC|CTAATAAGCATCGGCAATCAACTTCGGAAG
GGCAATCAACCGTCTCAAGTGTTAAGCTGG|CGACTGGAGTAACATATGTATCATGTAGCG
GAGGACCTCTCGGAAGTCTAATAAGCATCG|AATCAACGTACTATCGGAAGTCTAATAAGC
ACGTTATCGCCTGAGCCCACACAAGGTCGC|GTTTCATACCTATATATCGGAAGTCTAATA
CAGGCCTATAAGCGGTCACCTTTAAAGCGA|CACGCTCGGAAGTCTAATAAGCATCGGCAA
CACTCTGGGAGTAATTTGCGCAAAAAAACA|AAGTCTAATAAGCATCGGCAATCAACTAAT
CTCTGCGTCGGAAGTCTAATAAGCATCGGC|TGTCAGGACCACTTAAGTAACTTACAGGTC
GCATCGGCAATCAACGTTATCGCCTGAGCC|AGATTCGGTAATTGTTTCATACCTATATAT
GACGATCAGATTCGGTAATTGTTTCATACC|AGGAAATCCGGCACATCTGGAGTACCAGAA
TTGTAGGGGGAAGATGCGCTACATTTCGTA|CCAAAATTTCCTGGGCGACCCGCTCCCCAA
AAGGTCGCACGGGAGTGCCCCACGGACACC|GTCTAATAAGCATCGGCAATCAACTCGGAA
GTCAGGACCACTTAAGTAACTTACAGGTCG|AGTAATTTGCGCAAAAAAACAACATATTAG
CGTACTATCGGAAGTCTAATAAGCATCGGC|CTTCGGAAGTCTAATAAGCATCGGCAATCA
CTCTTGTCGAATGTGCAAGATCGTAACGCT|AGCGGTCACCTTTAAAGCGAGGACCTCTCG
CCCCGAGAGTAGCCAAGGTTAGGGTGATGA|AATCAACGTTATCGCCTGAGCCCACACAAG
TAAGCATCGGCAATCAACGTTATCGCCTGA|ATCAGATTCGGTAATTGTTTCATACCTATA
CTCAAGTCGGAAGTCTAATAAGCATCGGCA|CTCTAATTAAGATGCACGCCCAAGGATTTC
AGTACCGCAAACCCCACCTCTTGTCGAATG|AGCTGGGCAGGCCTATAAGCGGTCACCTTT
CGGTAATTGTTTCATACCTATATATCGGAA|ACATCTGGAGTACCAGAACACTAACTCGGA
TTCGGAAGTCTAATAAGCATCGGCAATCAA|ATAAGCATCGGCAATCAACCGTCTCAAGTG
TCACTGCTCAAAGCCTCGGAAGTCTAATAA|CGGAAGTCTAATAAGCATCGGCAATCAACC
AGCGAGGACCTCTCGGAAGTCTAATAAGCA|GGCAATCAACGTACTATCGGAAGTCTAATA
TTCTCTAATTAAGATGCACGCCCAAGGATT|TGAAGACGGGGACGGCGTTTACGTTCTTAA
GAAGTCTCGGAAGTCTAATAAGCATCGGCA|TCGGAAGTCTAATAAGCATCGGCAATCAAC
CGAAACCTGTCACTGCCAGTTATTCTCTAA|GAGCTCACACGACATGTTAGGATGAAGACG
GCAAACCCCACCTCTTGTCGAATGTGCAAG|GCAGGCCTATAAGCGGTCACCTTTAAAGCG
TACATTTCGTACAAAGGGAGATATAACATG|CCGCTCCCCAATAAGGTCTTGATGCGGGTC
TCTACGCTCTCAAGTCGGAAGTCTAATAAG|CAGTTATTCTCTAATTAAGATGCACGCCCA
CGCCCAAGGATTTCTACATTGTAGGGGGAA|TTACGTTCTTAAAGCTTTCCAAAATTTCCT
ATAAGCATCGGCAATTCGGAAGTCTAATAA|TCTAATAAGCATCGGCAATCAACTAACAAC
GGGAGTAATTTGCGCAAAAAAACAACATAT|AATAAGCATCGGCAATCAACTAATAAGCAT
TCGGCAATCAACTCGGAAGTCTCGGAAGTC|ATCGGCAATCAACGTTCGGAAGTCTAATAA
CAATCAACGACGCGTCCGATCTGGGGTGGG|TCGTACAAAGGGAGATATAACATGTGACTA
TCACCTTTAAAGCGAGGACCTCTCGGAAGT|AATAAGCATCGGCAATCAACGTACTATCGG
GGTCACCTTTAAAGCGAGGACCTCTCGGAA|CTAATAAGCATCGGCAATCAACGTACTATC
AATCAACCGTCTCAAGTGTTAAGCTGGGCA|CTGGAGTAACATATGTATCATGTAGCGACA
AAGGAGCGGTCAATCTGATTCCTCACAGGC|GTCTAATAAGCATCGGCAATCAACTACCTG
GTGGATAAAGGAGCGGTCAATCTGATTCCT|GTCGGAAGTCTAATAAGCATCGGCAATCAA
AACGTACTATCGGAAGTCTAATAAGCATCG|AACTTCGGAAGTCTAATAAGCATCGGCAAT
TGAAGGTACAATCTCTCGTTTATGCGATGC|GTCGCACGGGAGTGCCCCACGGACACCGGT
ATCGCCTTCACTGCTCAAAGCCTCGGAAGT|GGCAATTCGGAAGTCTAATAAGCATCGGCA
AAGTCTAATAAGCATCGGCAATCAACCAAC|CAACTAACAACATCTGCCGTTGGATGAACG
TCAGATTCGGTAATTGTTTCATACCTATAT|ATCCGGCACATCTGGAGTACCAGAACACTA
TAAGCATCGGCAATCAACTAATAAGCATCG|TCGGCAATCAACCAAGTACCGCAAACCCCA
GCTGGGCAGGCCTATAAGCGGTCACCTTTA|TAGCGACACGCTCGGAAGTCTAATAAGCAT
GAAGTCTAATAAGCATCGGCAATCAACTAC|ACTTAAGTAACTTACAGGTCGCCAATCGGA
CACTAACTCGGAAGTCTAATAAGCATCGGC|CTAAAATCGCCTTCACTGCTCAAAGCCTCG
AGCTGCACGTCGAGAGTTACTCTGCGTCGG|GCGATGCTAGTTCTATATCTGTCAGGACCA
ACGCTAACACGTGGATAAAGGAGCGGTCAA|GTTACTCTGCGTCGGAAGTCTAATAAGCAT
AGATGCACGCCCAAGGATTTCTACATTGTA|ACGGCGTTTACGTTCTTAAAGCTTTCCAAA
AGGCACTGCGCGTCGGAAGTCTAATAAGCA|CCTGACACTTCTCGGGTGGCCCCGAGAGTA
GACCTCTCGGAAGTCTAATAAGCATCGGCA|CAACGTACTATCGGAAGTCTAATAAGCATC
GGTCGTTCCATCTACGCTCTCAAGTCGGAA|CTGTCACTGCCAGTTATTCTCTAATTAAGA
CGGAAGTCTAATAAGCATCGGCAATTCGGA|CTATCGGAAGTCTAATAAGCATCGGCAATC
ATAAGCATCGGCAATCAACCAACCCCGACT|CAACATCTGCCGTTGGATGAACGGTGTCAC
CGAGGACCTCTCGGAAGTCTAATAAGCATC|CAATCAACGTACTATCGGAAGTCTAATAAG
CGGCAATCAACTAACAACATCTGCCGTTGG|ATCAACGACGCGTCCGATCTGGGGTGGGCA
AGCATCGGCAATTCGGAAGTCTAATAAGCA|AATAAGCATCGGCAATCAACTAACAACATC
AGTAACTTACAGGTCGCCAATCGGAAGTCT|AAAAACAACATATTAGCAAGAAAGTATGGA
TAATAAGCATCGGCAATCAACTAATAAGCA|GCATCGGCAATCAACCAAGTACCGCAAACC
GCCCAAGGATTTCTACATTGTAGGGGGAAG|TACGTTCTTAAAGCTTTCCAAAATTTCCTG
CACCTTTAAAGCGAGGACCTCTCGGAAGTC|ATAAGCATCGGCAATCAACGTACTATCGGA
TCGGAAGTCTCGGAAGTCTAATAAGCATCG|CGTTCGGAAGTCTAATAAGCATCGGCAATC
GGATCTACTAAAATCGCCTTCACTGCTCAA|CTAATAAGCATCGGCAATTCGGAAGTCTAA
AGCGGTCAATCTGATTCCTCACAGGCACTG|AATAAGCATCGGCAATCAACTACCTGACAC
CGGCAATCAACCAAGTACCGCAAACCCCAC|GTCTCAAGTGTTAAGCTGGGCAGGCCTATA
TTTAAAGCGAGGACCTCTCGGAAGTCTAAT|GCATCGGCAATCAACGTACTATCGGAAGTC
ATACCTATATATCGGAAGTCTAATAAGCAT|CAGAACACTAACTCGGAAGTCTAATAAGCA
ATTATGGATCGAAACCTGTCACTGCCAGTT|ATCTTCACTGAGCTCACACGACATGTTAGG
GTGGCACACTCTGGGAGTAATTTGCGCAAA|TCTCGGAAGTCTAATAAGCATCGGCAATCA
GGAAGTCTCGGAAGTCTAATAAGCATCGGC|TTCGGAAGTCTAATAAGCATCGGCAATCAA
CATCGGCAATCAACGTTATCGCCTGAGCCC|GATTCGGTAATTGTTTCATACCTATATATC
TCGGAAGTCTAATAAGCATCGGCAATCAAC|AAAGTATGGACGATCAGATTCGGTAATTGT
CTATCGGAAGTCTAATAAGCATCGGCAATC|GGAAGTCTAATAAGCATCGGCAATCAACGA
CAAGGTCGCACGGGAGTGCCCCACGGACAC|AGTCTAATAAGCATCGGCAATCAACTCGGA
ATCGGCAATCAACTTCGGAAGTCTAATAAG|GGATTTCTACATTGTAGGGGGAAGATGCGC
TAATTAAGATGCACGCCCAAGGATTTCTAC|ACGGGGACGGCGTTTACGTTCTTAAAGCTT
CACCAGTAATTATGGATCGAAACCTGTCAC|TAATTTCGATCTTCACTGAGCTCACACGAC
CAGCTGCACGTCGAGAGTTACTCTGCGTCG|TGCGATGCTAGTTCTATATCTGTCAGGACC
GGTGTCACTCGGCTCGGTCGTTCCATCTAC|ATTATGGATCGAAACCTGTCACTGCCAGTT
CGGAAGTCTAATAAGCATCGGCAATCAACG|AGGGGGAAGATGCGCTACATTTCGTACAAA
CCCACGGACACCGGTGGCACACTCTGGGAG|ATCAACTCGGAAGTCTCGGAAGTCTAATAA
CCTCTCGGAAGTCTAATAAGCATCGGCAAT|ACGTACTATCGGAAGTCTAATAAGCATCGG
CATCTGCCGTTGGATGAACGGTGTCACTCG|TCTGGGGTGGGCACCAGTAATTATGGATCG
CTCTGGGAGTAATTTGCGCAAAAAAACAAC|GTCTAATAAGCATCGGCAATCAACTAATAA
GCAATCAACTAACAACATCTGCCGTTGGAT|CAACGACGCGTCCGATCTGGGGTGGGCACC
GTACAATCTCTCGTTTATGCGATGCTAGTT|ACGGGAGTGCCCCACGGACACCGGTGGCAC
ACTGCCAGTTATTCTCTAATTAAGATGCAC|ACATGTTAGGATGAAGACGGGGACGGCGTT
ACATTGTAGGGGGAAGATGCGCTACATTTC|TTTCCAAAATTTCCTGGGCGACCCGCTCCC
CTCGGAAGTCTAATAAGCATCGGCAATCAA|GCATCGGCAATCAACCAACCCCGACTGGAG
CAGGCACTGCGCGTCGGAAGTCTAATAAGC|ACCTGACACTTCTCGGGTGGCCCCGAGAGT
CAATCAACGTTATCGCCTGAGCCCACACAA|GTAATTGTTTCATACCTATATATCGGAAGT
AAGTCTAATAAGCATCGGCAATCAACTACC|CTTAAGTAACTTACAGGTCGCCAATCGGAA
CTGAGTCAAACATCACAGCTGCACGTCGAG|ACAATCTCTCGTTTATGCGATGCTAGTTCT
CTTCTCGGGTGGCCCCGAGAGTAGCCAAGG|ATAAGCATCGGCAATCAACGTTATCGCCTG
TTACTCTGCGTCGGAAGTCTAATAAGCATC|ATCTGTCAGGACCACTTAAGTAACTTACAG
ATGTGCAAGATCGTAACGCTAATAAGGATC|TTTAAAGCGAGGACCTCTCGGAAGTCTAAT
ACATCTGGAGTACCAGAACACTAACTCGGA|AACGCTAATAAGGATCTACTAAAATCGCCT
GGCAATCAACTTCGGAAGTCTAATAAGCAT|TTTCTACATTGTAGGGGGAAGATGCGCTAC
CTACATTTCGTACAAAGGGAGATATAACAT|CCCGCTCCCCAATAAGGTCTTGATGCGGGT
GTTACTCTGCGTCGGAAGTCTAATAAGCAT|TATCTGTCAGGACCACTTAAGTAACTTACA
GTATGCACTAAACTACGCTAACACGTGGAT|GCTGCACGTCGAGAGTTACTCTGCGTCGGA
CTCGTTTATGCGATGCTAGTTCTATATCTG|CCCCACGGACACCGGTGGCACACTCTGGGA
GTAACGCTAATAAGGATCTACTAAAATCGC|ACCTCTCGGAAGTCTAATAAGCATCGGCAA
CGGCAATCAACTACCTGACACTTCTCGGGT|GGTCGCCAATCGGAAGTCTAATAAGCATCG
CCACACAAGGTCGCACGGGAGTGCCCCACG|TCGGAAGTCTAATAAGCATCGGCAATCAAC
TCGAGAGTTACTCTGCGTCGGAAGTCTAAT|GTTCTATATCTGTCAGGACCACTTAAGTAA
GAACGGTGTCACTCGGCTCGGTCGTTCCAT|AGTAATTATGGATCGAAACCTGTCACTGCC
ACTACCTGACACTTCTCGGGTGGCCCCGAG|TCGGAAGTCTAATAAGCATCGGCAATCAAC
CTACGCTCTCAAGTCGGAAGTCTAATAAGC|AGTTATTCTCTAATTAAGATGCACGCCCAA
GGAAGTCTAATAAGCATCGGCAATTCGGAA|TATCGGAAGTCTAATAAGCATCGGCAATCA
TAAAGGAGCGGTCAATCTGATTCCTCACAG|AAGTCTAATAAGCATCGGCAATCAACTACC
GCTAAACCAATCTGAGTCAAACATCACAGC|ATGATGAAGGTACAATCTCTCGTTTATGCG
GGAGTAATTTGCGCAAAAAAACAACATATT|ATAAGCATCGGCAATCAACTAATAAGCATC
TGTTAAGCTGGGCAGGCCTATAAGCGGTCA|ATCATGTAGCGACACGCTCGGAAGTCTAAT
GATCGTAACGCTAATAAGGATCTACTAAAA|GAGGACCTCTCGGAAGTCTAATAAGCATCG
TAAGCATCGGCAATCAACCGGTAGGAAATC|CAAACCCCACCTCTTGTCGAATGTGCAAGA
TCAACCAACCCCGACTGGAGTAACATATGT|GGATGAACGGTGTCACTCGGCTCGGTCGTT
GACACCGGTGGCACACTCTGGGAGTAATTT|TCGGAAGTCTCGGAAGTCTAATAAGCATCG
CAACTACCTGACACTTCTCGGGTGGCCCCG|AATCGGAAGTCTAATAAGCATCGGCAATCA
CAATCAACTAATAAGCATCGGCAATCAACC|ACCAAGTACCGCAAACCCCACCTCTTGTCG
GGATCGAAACCTGTCACTGCCAGTTATTCT|CACTGAGCTCACACGACATGTTAGGATGAA
TCGAATGTGCAAGATCGTAACGCTAATAAG|CACCTTTAAAGCGAGGACCTCTCGGAAGTC
TATATCGGAAGTCTAATAAGCATCGGCAAT|CTAACTCGGAAGTCTAATAAGCATCGGCAA
AAGTCTAATAAGCATCGGCAATCAACGTTC|TTCACTGCTCAAAGCCTCGGAAGTCTAATA
GCATCGGCAATCAACCAAGTACCGCAAACC|AACCGTCTCAAGTGTTAAGCTGGGCAGGCC
CTTTAAAGCGAGGACCTCTCGGAAGTCTAA|AGCATCGGCAATCAACGTACTATCGGAAGT
TCGCCAATCGGAAGTCTAATAAGCATCGGC|TAGCAAGAAAGTATGGACGATCAGATTCGG
GTCTAATAAGCATCGGCAATCAACGTACTA|GTCTAATAAGCATCGGCAATCAACTTCGGA
TGAACGGTGTCACTCGGCTCGGTCGTTCCA|CAGTAATTATGGATCGAAACCTGTCACTGC
ATCGGCAATCAACTCGGAAGTCTCGGAAGT|CATCGGCAATCAACGTTCGGAAGTCTAATA
GGAAGTCTAATAAGCATCGGCAATCAACTA|TCTAATAAGCATCGGCAATCAACGACGCGT
AAGTCGGAAGTCTAATAAGCATCGGCAATC|TAATTAAGATGCACGCCCAAGGATTTCTAC
GTAGAACTCCACTGCGACTTTGACAACGTA|CTAAACCAATCTGAGTCAAACATCACAGCT
ATTCTCTAATTAAGATGCACGCCCAAGGAT|ATGAAGACGGGGACGGCGTTTACGTTCTTA
GCGCGTCGGAAGTCTAATAAGCATCGGCAA|CTTCTCGGGTGGCCCCGAGAGTAGCCAAGG
AACCGTCTCAAGTGTTAAGCTGGGCAGGCC|AGTAACATATGTATCATGTAGCGACACGCT
TAATAAGCATCGGCAATCAACGTACTATCG|TAATAAGCATCGGCAATCAACTTCGGAAGT
CACGGGAGTGCCCCACGGACACCGGTGGCA|AAGCATCGGCAATCAACTCGGAAGTCTCGG
ACTTCTCGGGTGGCCCCGAGAGTAGCCAAG|AATAAGCATCGGCAATCAACGTTATCGCCT
TACTATCGGAAGTCTAATAAGCATCGGCAA|TCGGAAGTCTAATAAGCATCGGCAATCAAC
TACTCTGCGTCGGAAGTCTAATAAGCATCG|TCTGTCAGGACCACTTAAGTAACTTACAGG
CACCTCTTGTCGAATGTGCAAGATCGTAAC|ATAAGCGGTCACCTTTAAAGCGAGGACCTC
GAGTTACTCTGCGTCGGAAGTCTAATAAGC|TATATCTGTCAGGACCACTTAAGTAACTTA
TCTAATAAGCATCGGCAATCAACTTGGCTA|CCCCGAGAGTAGCCAAGGTTAGGGTGATGA
GGTGGCCCCGAGAGTAGCCAAGGTTAGGGT|TCGGCAATCAACGTTATCGCCTGAGCCCAC
ATTGTAGGGGGAAGATGCGCTACATTTCGT|TCCAAAATTTCCTGGGCGACCCGCTCCCCA
CCCACCTCTTGTCGAATGTGCAAGATCGTA|CTATAAGCGGTCACCTTTAAAGCGAGGACC
TCGGAAGTCTAATAAGCATCGGCAATCAAC|CGCCTTCACTGCTCAAAGCCTCGGAAGTCT
TGTTTCATACCTATATATCGGAAGTCTAAT|GAGTACCAGAACACTAACTCGGAAGTCTAA
AGAACACTAACTCGGAAGTCTAATAAGCAT|TCTACTAAAATCGCCTTCACTGCTCAAAGC
GTACCGCAAACCCCACCTCTTGTCGAATGT|GCTGGGCAGGCCTATAAGCGGTCACCTTTA
TCTAATAAGCATCGGCAATCAACCGTCTCA|AATCAACCAACCCCGACTGGAGTAACATAT
ATCCGGCACATCTGGAGTACCAGAACACTA|AGATCGTAACGCTAATAAGGATCTACTAAA
CCAAGGATTTCTACATTGTAGGGGGAAGAT|CGTTCTTAAAGCTTTCCAAAATTTCCTGGG
TGTGCAAGATCGTAACGCTAATAAGGATCT|TTAAAGCGAGGACCTCTCGGAAGTCTAATA
CTCGGCTCGGTCGTTCCATCTACGCTCTCA|ATCGAAACCTGTCACTGCCAGTTATTCTCT
ATCGGCAATTCGGAAGTCTAATAAGCATCG|AAGCATCGGCAATCAACTAACAACATCTGC
GAAGTCTAATAAGCATCGGCAATCAACTCG|GGAAGTCTAATAAGCATCGGCAATCAACGT
CGATCTGGGGTGGGCACCAGTAATTATGGA|ATAACATGTGACTATAATTTCGATCTTCAC
CGTCGAGAGTTACTCTGCGTCGGAAGTCTA|TAGTTCTATATCTGTCAGGACCACTTAAGT
ATCGGCAATCAACTAATAAGCATCGGCAAT|AATCAACCAAGTACCGCAAACCCCACCTCT
GGAAGTCTAATAAGCATCGGCAATCAACGT|AGTATGGACGATCAGATTCGGTAATTGTTT
TATCATGTAGCGACACGCTCGGAAGTCTAA|TCCATCTACGCTCTCAAGTCGGAAGTCTAA
AACATATGTATCATGTAGCGACACGCTCGG|TCGGTCGTTCCATCTACGCTCTCAAGTCGG
CGGTCAATCTGATTCCTCACAGGCACTGCG|TAAGCATCGGCAATCAACTACCTGACACTT
GCTAATAAGGATCTACTAAAATCGCCTTCA|TCGGAAGTCTAATAAGCATCGGCAATTCGG
TCGGCAATTCGGAAGTCTAATAAGCATCGG|AGCATCGGCAATCAACTAACAACATCTGCC
TACCGCAAACCCCACCTCTTGTCGAATGTG|CTGGGCAGGCCTATAAGCGGTCACCTTTAA
GTAATTGTTTCATACCTATATATCGGAAGT|ATCTGGAGTACCAGAACACTAACTCGGAAG
TAAGTAACTTACAGGTCGCCAATCGGAAGT|AAAAAAACAACATATTAGCAAGAAAGTATG
CGCTACATTTCGTACAAAGGGAGATATAAC|GACCCGCTCCCCAATAAGGTCTTGATGCGG
TAACTTACAGGTCGCCAATCGGAAGTCTAA|AAACAACATATTAGCAAGAAAGTATGGACG
AACCCCACCTCTTGTCGAATGTGCAAGATC|GGCCTATAAGCGGTCACCTTTAAAGCGAGG
TAATAAGCATCGGCAATTCGGAAGTCTAAT|AGTCTAATAAGCATCGGCAATCAACTAACA
GGAGCGGTCAATCTGATTCCTCACAGGCAC|CTAATAAGCATCGGCAATCAACTACCTGAC
GTAATTTGCGCAAAAAAACAACATATTAGC|AGCATCGGCAATCAACTAATAAGCATCGGC
CCAACCCCGACTGGAGTAACATATGTATCA|GAACGGTGTCACTCGGCTCGGTCGTTCCAT
AAACAACATATTAGCAAGAAAGTATGGACG|CTAATAAGCATCGGCAATCAACCGGTAGGA
CCAGAACACTAACTCGGAAGTCTAATAAGC|GATCTACTAAAATCGCCTTCACTGCTCAAA
TACAATCTCTCGTTTATGCGATGCTAGTTC|CGGGAGTGCCCCACGGACACCGGTGGCACA
CACTGCGACTTTGACAACGTATGCACTAAA|TCTGAGTCAAACATCACAGCTGCACGTCGA
AATAAGCATCGGCAATTCGGAAGTCTAATA|GTCTAATAAGCATCGGCAATCAACTAACAA
GGTAATTGTTTCATACCTATATATCGGAAG|CATCTGGAGTACCAGAACACTAACTCGGAA
CATCGGCAATCAACCGTCTCAAGTGTTAAG|ACCCCGACTGGAGTAACATATGTATCATGT
ACATATTAGCAAGAAAGTATGGACGATCAG|AAGCATCGGCAATCAACCGGTAGGAAATCC
ACGCTCTCAAGTCGGAAGTCTAATAAGCAT|TTATTCTCTAATTAAGATGCACGCCCAAGG
TGACAACGTATGCACTAAACTACGCTAACA|CATCACAGCTGCACGTCGAGAGTTACTCTG
GGCAATCAACGTACTATCGGAAGTCTAATA|GGCAATCAACTTCGGAAGTCTAATAAGCAT
ACACTCTGGGAGTAATTTGCGCAAAAAAAC|GAAGTCTAATAAGCATCGGCAATCAACTAA
GCAATTCGGAAGTCTAATAAGCATCGGCAA|ATCGGCAATCAACTAACAACATCTGCCGTT
CTGTCACTGCCAGTTATTCTCTAATTAAGA|ACACGACATGTTAGGATGAAGACGGGGACG
CTTCGGAAGTCTAATAAGCATCGGCAATCA|TGTAGGGGGAAGATGCGCTACATTTCGTAC
CCGGTGGCACACTCTGGGAGTAATTTGCGC|AAGTCTCGGAAGTCTAATAAGCATCGGCAA
CAATCAACCAACCCCGACTGGAGTAACATA|GTTGGATGAACGGTGTCACTCGGCTCGGTC
CGGTCGTTCCATCTACGCTCTCAAGTCGGA|CCTGTCACTGCCAGTTATTCTCTAATTAAG
GCACGCCCAAGGATTTCTACATTGTAGGGG|CGTTTACGTTCTTAAAGCTTTCCAAAATTT
GGCAATCAACCAAGTACCGCAAACCCCACC|TCTCAAGTGTTAAGCTGGGCAGGCCTATAA
ATAAGCATCGGCAATCAACTTGGCTAAACC|GAGAGTAGCCAAGGTTAGGGTGATGATGAA
AACGCTAATAAGGATCTACTAAAATCGCCT|CTCTCGGAAGTCTAATAAGCATCGGCAATT
CCTCACAGGCACTGCGCGTCGGAAGTCTAA|CAACTACCTGACACTTCTCGGGTGGCCCCG
GTACTATCGGAAGTCTAATAAGCATCGGCA|TTCGGAAGTCTAATAAGCATCGGCAATCAA
ATTCCTCACAGGCACTGCGCGTCGGAAGTC|AATCAACTACCTGACACTTCTCGGGTGGCC
TTAAAGCGAGGACCTCTCGGAAGTCTAATA|CATCGGCAATCAACGTACTATCGGAAGTCT
CAGTAATTATGGATCGAAACCTGTCACTGC|TTTCGATCTTCACTGAGCTCACACGACATG
AAACCAATCTGAGTCAAACATCACAGCTGC|ATGAAGGTACAATCTCTCGTTTATGCGATG
AATCCGGCACATCTGGAGTACCAGAACACT|AAGATCGTAACGCTAATAAGGATCTACTAA
CGTATGCACTAAACTACGCTAACACGTGGA|AGCTGCACGTCGAGAGTTACTCTGCGTCGG
AGTCTCGGAAGTCTAATAAGCATCGGCAAT|GGAAGTCTAATAAGCATCGGCAATCAACCA
GCGCTACATTTCGTACAAAGGGAGATATAA|CGACCCGCTCCCCAATAAGGTCTTGATGCG
TCTAATTAAGATGCACGCCCAAGGATTTCT|AGACGGGGACGGCGTTTACGTTCTTAAAGC
CCTCGGAAGTCTAATAAGCATCGGCAATCA|AGCATCGGCAATCAACCAACCCCGACTGGA
GCATCGGCAATCAACTACCTGACACTTCTC|TACAGGTCGCCAATCGGAAGTCTAATAAGC
GCACGGGAGTGCCCCACGGACACCGGTGGC|TAAGCATCGGCAATCAACTCGGAAGTCTCG
TTTCTACATTGTAGGGGGAAGATGCGCTAC|AAAGCTTTCCAAAATTTCCTGGGCGACCCG
CAGAACACTAACTCGGAAGTCTAATAAGCA|ATCTACTAAAATCGCCTTCACTGCTCAAAG
AAGCGGTCACCTTTAAAGCGAGGACCTCTC|AAGTCTAATAAGCATCGGCAATCAACGTAC
ATCAACCGGTAGGAAATCCGGCACATCTGG|CTTGTCGAATGTGCAAGATCGTAACGCTAA
CGTTGGATGAACGGTGTCACTCGGCTCGGT|TGGGCACCAGTAATTATGGATCGAAACCTG
GGAAGTCTAATAAGCATCGGCAATCAACCA|AGCATCGGCAATCAACCGTCTCAAGTGTTA
TTCTCGGGTGGCCCCGAGAGTAGCCAAGGT|TAAGCATCGGCAATCAACGTTATCGCCTGA
AAAAAACAACATATTAGCAAGAAAGTATGG|CAACTAATAAGCATCGGCAATCAACCGGTA
AATCAACGTTATCGCCTGAGCCCACACAAG|TAATTGTTTCATACCTATATATCGGAAGTC
AATCAACGACGCGTCCGATCTGGGGTGGGC|CGTACAAAGGGAGATATAACATGTGACTAT
ATTCGGAAGTCTAATAAGCATCGGCAATCA|GGCAATCAACTAACAACATCTGCCGTTGGA
ACTAAACTACGCTAACACGTGGATAAAGGA|CGTCGAGAGTTACTCTGCGTCGGAAGTCTA
AATCGGAAGTCTAATAAGCATCGGCAATCA|AGAAAGTATGGACGATCAGATTCGGTAATT
AGTCTAATAAGCATCGGCAATCAACTTCGG|ATGCACGCCCAAGGATTTCTACATTGTAGG
CAACCCCGACTGGAGTAACATATGTATCAT|AACGGTGTCACTCGGCTCGGTCGTTCCATC
GAGCCCACACAAGGTCGCACGGGAGTGCCC|TATATCGGAAGTCTAATAAGCATCGGCAAT
GCTGCACGTCGAGAGTTACTCTGCGTCGGA|CGATGCTAGTTCTATATCTGTCAGGACCAC
AATCAACCAACCCCGACTGGAGTAACATAT|TTGGATGAACGGTGTCACTCGGCTCGGTCG
ATGCACTAAACTACGCTAACACGTGGATAA|TGCACGTCGAGAGTTACTCTGCGTCGGAAG
AAACTACGCTAACACGTGGATAAAGGAGCG|CGAGAGTTACTCTGCGTCGGAAGTCTAATA
AGCCAAGGTTAGGGTGATGATGAAGGTACA|ATCGCCTGAGCCCACACAAGGTCGCACGGG
TCCGGCACATCTGGAGTACCAGAACACTAA|GATCGTAACGCTAATAAGGATCTACTAAAA
CTAATAAGCATCGGCAATCAACTAATAAGC|AGCATCGGCAATCAACCAAGTACCGCAAAC
AGAACTCCACTGCGACTTTGACAACGTATG|AAACCAATCTGAGTCAAACATCACAGCTGC
AACACGTGGATAAAGGAGCGGTCAATCTGA|TCTGCGTCGGAAGTCTAATAAGCATCGGCA
TAGGGGGAAGATGCGCTACATTTCGTACAA|AAATTTCCTGGGCGACCCGCTCCCCAATAA
TCAACGTTATCGCCTGAGCCCACACAAGGT|ATTGTTTCATACCTATATATCGGAAGTCTA
TTTGACAACGTATGCACTAAACTACGCTAA|AACATCACAGCTGCACGTCGAGAGTTACTC
TCAAAGCCTCGGAAGTCTAATAAGCATCGG|CTAATAAGCATCGGCAATCAACCAACCCCG
TCTGGGGTGGGCACCAGTAATTATGGATCG|ACATGTGACTATAATTTCGATCTTCACTGA
TCACTCGGCTCGGTCGTTCCATCTACGCTC|TGGATCGAAACCTGTCACTGCCAGTTATTC
GCATCGGCAATTCGGAAGTCTAATAAGCAT|ATAAGCATCGGCAATCAACTAACAACATCT
TCACTGCCAGTTATTCTCTAATTAAGATGC|CGACATGTTAGGATGAAGACGGGGACGGCG
AAAGTATGGACGATCAGATTCGGTAATTGT|CAACCGGTAGGAAATCCGGCACATCTGGAG
CCGAGAGTAGCCAAGGTTAGGGTGATGATG|TCAACGTTATCGCCTGAGCCCACACAAGGT
CTAATAAGCATCGGCAATTCGGAAGTCTAA|AAGTCTAATAAGCATCGGCAATCAACTAAC
GACGCGTCCGATCTGGGGTGGGCACCAGTA|AGGGAGATATAACATGTGACTATAATTTCG
TTCGGAAGTCTAATAAGCATCGGCAATCAA|GCAATCAACTAACAACATCTGCCGTTGGAT
GGATGAACGGTGTCACTCGGCTCGGTCGTT|CACCAGTAATTATGGATCGAAACCTGTCAC
CCCCACGGACACCGGTGGCACACTCTGGGA|AATCAACTCGGAAGTCTCGGAAGTCTAATA
TGTCACTCGGCTCGGTCGTTCCATCTACGC|TATGGATCGAAACCTGTCACTGCCAGTTAT
TGATGAAGGTACAATCTCTCGTTTATGCGA|AAGGTCGCACGGGAGTGCCCCACGGACACC
GGTTAGGGTGATGATGAAGGTACAATCTCT|TGAGCCCACACAAGGTCGCACGGGAGTGCC
AGCATCGGCAATCAACTTCGGAAGTCTAAT|CAAGGATTTCTACATTGTAGGGGGAAGATG
GTGGCCCCGAGAGTAGCCAAGGTTAGGGTG|CGGCAATCAACGTTATCGCCTGAGCCCACA
CGGAAGTCTAATAAGCATCGGCAATCAACC|AAGCATCGGCAATCAACCGTCTCAAGTGTT
TTTCATACCTATATATCGGAAGTCTAATAA|GTACCAGAACACTAACTCGGAAGTCTAATA
AGGAGCGGTCAATCTGATTCCTCACAGGCA|TCTAATAAGCATCGGCAATCAACTACCTGA
TGATGATGAAGGTACAATCTCTCGTTTATG|CACAAGGTCGCACGGGAGTGCCCCACGGAC
CAAGATCGTAACGCTAATAAGGATCTACTA|AGCGAGGACCTCTCGGAAGTCTAATAAGCA
TCGGCAATCAACTAATAAGCATCGGCAATC|ATCAACCAAGTACCGCAAACCCCACCTCTT
CGCACGGGAGTGCCCCACGGACACCGGTGG|ATAAGCATCGGCAATCAACTCGGAAGTCTC
ACGTATGCACTAAACTACGCTAACACGTGG|CAGCTGCACGTCGAGAGTTACTCTGCGTCG
CAATCTGAGTCAAACATCACAGCTGCACGT|AGGTACAATCTCTCGTTTATGCGATGCTAG
AATAAGCATCGGCAATCAACTAACAACATC|GCATCGGCAATCAACGACGCGTCCGATCTG
TCTCGTTTATGCGATGCTAGTTCTATATCT|GCCCCACGGACACCGGTGGCACACTCTGGG
ATCATGTAGCGACACGCTCGGAAGTCTAAT|CCATCTACGCTCTCAAGTCGGAAGTCTAAT
TTAAGCTGGGCAGGCCTATAAGCGGTCACC|CATGTAGCGACACGCTCGGAAGTCTAATAA
TAGCGACACGCTCGGAAGTCTAATAAGCAT|ACGCTCTCAAGTCGGAAGTCTAATAAGCAT
CCCACACAAGGTCGCACGGGAGTGCCCCAC|ATCGGAAGTCTAATAAGCATCGGCAATCAA
CGGCAATCAACCGTCTCAAGTGTTAAGCTG|CCGACTGGAGTAACATATGTATCATGTAGC
GGGTGGGCACCAGTAATTATGGATCGAAAC|GTGACTATAATTTCGATCTTCACTGAGCTC
TGTCACTGCCAGTTATTCTCTAATTAAGAT|CACGACATGTTAGGATGAAGACGGGGACGG
TCGGAAGTCTAATAAGCATCGGCAATCAAC|CTCGGAAGTCTAATAAGCATCGGCAATCAA
CACTGCCAGTTATTCTCTAATTAAGATGCA|GACATGTTAGGATGAAGACGGGGACGGCGT
ATCAACCGTCTCAAGTGTTAAGCTGGGCAG|TGGAGTAACATATGTATCATGTAGCGACAC
CTAATAAGGATCTACTAAAATCGCCTTCAC|CGGAAGTCTAATAAGCATCGGCAATTCGGA
CGGCAATCAACGTACTATCGGAAGTCTAAT|CGGCAATCAACTTCGGAAGTCTAATAAGCA
TCGGAAGTCTAATAAGCATCGGCAATCAAC|TTAAGATGCACGCCCAAGGATTTCTACATT
CTCAAGTGTTAAGCTGGGCAGGCCTATAAG|ATATGTATCATGTAGCGACACGCTCGGAAG
ATCGAAACCTGTCACTGCCAGTTATTCTCT|CTGAGCTCACACGACATGTTAGGATGAAGA
CCTGTCACTGCCAGTTATTCTCTAATTAAG|CACACGACATGTTAGGATGAAGACGGGGAC
GGCAGGCCTATAAGCGGTCACCTTTAAAGC|GACACGCTCGGAAGTCTAATAAGCATCGGC
AGAAAGTATGGACGATCAGATTCGGTAATT|ATCAACCGGTAGGAAATCCGGCACATCTGG
TTCGGAAGTCTAATAAGCATCGGCAATCAA|GTAGGGGGAAGATGCGCTACATTTCGTACA
ACCTGTCACTGCCAGTTATTCTCTAATTAA|TCACACGACATGTTAGGATGAAGACGGGGA
GACAACGTATGCACTAAACTACGCTAACAC|ATCACAGCTGCACGTCGAGAGTTACTCTGC
GTATGGACGATCAGATTCGGTAATTGTTTC|CCGGTAGGAAATCCGGCACATCTGGAGTAC
TCGGCAATCAACGTTATCGCCTGAGCCCAC|TTCGGTAATTGTTTCATACCTATATATCGG
CCTATAAGCGGTCACCTTTAAAGCGAGGAC|CTCGGAAGTCTAATAAGCATCGGCAATCAA
GAAATCCGGCACATCTGGAGTACCAGAACA|GCAAGATCGTAACGCTAATAAGGATCTACT
GGGGGAAGATGCGCTACATTTCGTACAAAG|ATTTCCTGGGCGACCCGCTCCCCAATAAGG
AAGCATCGGCAATCAACGACGCGTCCGATC|CGCTACATTTCGTACAAAGGGAGATATAAC
GCACGTCGAGAGTTACTCTGCGTCGGAAGT|TGCTAGTTCTATATCTGTCAGGACCACTTA
TCGGAAGTCTAATAAGCATCGGCAATCAAC|TAAGCATCGGCAATCAACCGTCTCAAGTGT
AAGCATCGGCAATTCGGAAGTCTAATAAGC|TAATAAGCATCGGCAATCAACTAACAACAT
AGGATTTCTACATTGTAGGGGGAAGATGCG|TCTTAAAGCTTTCCAAAATTTCCTGGGCGA
CTAATAAGCATCGGCAATCAACCGGTAGGA|ACCGCAAACCCCACCTCTTGTCGAATGTGC
GGCACCAGTAATTATGGATCGAAACCTGTC|TATAATTTCGATCTTCACTGAGCTCACACG
AAGGTTAGGGTGATGATGAAGGTACAATCT|CCTGAGCCCACACAAGGTCGCACGGGAGTG
GTCGCACGGGAGTGCCCCACGGACACCGGT|TAATAAGCATCGGCAATCAACTCGGAAGTC
CGGAAGTCTCGGAAGTCTAATAAGCATCGG|GTTCGGAAGTCTAATAAGCATCGGCAATCA
CCACCTCTTGTCGAATGTGCAAGATCGTAA|TATAAGCGGTCACCTTTAAAGCGAGGACCT
ACAACGTATGCACTAAACTACGCTAACACG|TCACAGCTGCACGTCGAGAGTTACTCTGCG
CGTAACGCTAATAAGGATCTACTAAAATCG|GACCTCTCGGAAGTCTAATAAGCATCGGCA
GAGTCAAACATCACAGCTGCACGTCGAGAG|AATCTCTCGTTTATGCGATGCTAGTTCTAT
GGGGAAGATGCGCTACATTTCGTACAAAGG|TTTCCTGGGCGACCCGCTCCCCAATAAGGT
TAATAAGCATCGGCAATCAACTAACAACAT|AGCATCGGCAATCAACGACGCGTCCGATCT
CTAATAAGCATCGGCAATCAACTTCGGAAG|CACGCCCAAGGATTTCTACATTGTAGGGGG
AAGTCTAATAAGCATCGGCAATCAACCAAG|CATCGGCAATCAACCGTCTCAAGTGTTAAG
TAACACGTGGATAAAGGAGCGGTCAATCTG|CTCTGCGTCGGAAGTCTAATAAGCATCGGC
CAGGTCGCCAATCGGAAGTCTAATAAGCAT|ATATTAGCAAGAAAGTATGGACGATCAGAT
GCTAACACGTGGATAAAGGAGCGGTCAATC|TACTCTGCGTCGGAAGTCTAATAAGCATCG
ACTCGGAAGTCTAATAAGCATCGGCAATCA|ATCGCCTTCACTGCTCAAAGCCTCGGAAGT
CCCCGACTGGAGTAACATATGTATCATGTA|GGTGTCACTCGGCTCGGTCGTTCCATCTAC
CAATCAACGTTCGGAAGTCTAATAAGCATC|GGAAGTCTAATAAGCATCGGCAATCAACCG
TCAACTTCGGAAGTCTAATAAGCATCGGCA|ACATTGTAGGGGGAAGATGCGCTACATTTC
AAGCATCGGCAATCAACCGGTAGGAAATCC|AAACCCCACCTCTTGTCGAATGTGCAAGAT
AACTTCGGAAGTCTAATAAGCATCGGCAAT|ATTGTAGGGGGAAGATGCGCTACATTTCGT
CCACTGCGACTTTGACAACGTATGCACTAA|ATCTGAGTCAAACATCACAGCTGCACGTCG
TCGGCAATCAACGACGCGTCCGATCTGGGG|CATTTCGTACAAAGGGAGATATAACATGTG
GTGTCACTCGGCTCGGTCGTTCCATCTACG|TTATGGATCGAAACCTGTCACTGCCAGTTA
ATCGGCAATCAACGACGCGTCCGATCTGGG|ACATTTCGTACAAAGGGAGATATAACATGT
AACTCGGAAGTCTCGGAAGTCTAATAAGCA|CAACGTTCGGAAGTCTAATAAGCATCGGCA
TTCTACATTGTAGGGGGAAGATGCGCTACA|AAGCTTTCCAAAATTTCCTGGGCGACCCGC
TTATCGCCTGAGCCCACACAAGGTCGCACG|TCATACCTATATATCGGAAGTCTAATAAGC
TCAACTACCTGACACTTCTCGGGTGGCCCC|CAATCGGAAGTCTAATAAGCATCGGCAATC
CATGTAGCGACACGCTCGGAAGTCTAATAA|ATCTACGCTCTCAAGTCGGAAGTCTAATAA
CGTCCGATCTGGGGTGGGCACCAGTAATTA|AGATATAACATGTGACTATAATTTCGATCT
CGGTGGCACACTCTGGGAGTAATTTGCGCA|AGTCTCGGAAGTCTAATAAGCATCGGCAAT
CGGTGTCACTCGGCTCGGTCGTTCCATCTA|AATTATGGATCGAAACCTGTCACTGCCAGT
AATAAGCATCGGCAATCAACCGGTAGGAAA|CGCAAACCCCACCTCTTGTCGAATGTGCAA
CCTCTTGTCGAATGTGCAAGATCGTAACGC|AAGCGGTCACCTTTAAAGCGAGGACCTCTC
CGTTATCGCCTGAGCCCACACAAGGTCGCA|TTTCATACCTATATATCGGAAGTCTAATAA
GCATCGGCAATCAACCGGTAGGAAATCCGG|ACCCCACCTCTTGTCGAATGTGCAAGATCG
GAGAGTTACTCTGCGTCGGAAGTCTAATAA|TCTATATCTGTCAGGACCACTTAAGTAACT
GAGTGCCCCACGGACACCGGTGGCACACTC|TCGGCAATCAACTCGGAAGTCTCGGAAGTC
AAAGCCTCGGAAGTCTAATAAGCATCGGCA|AATAAGCATCGGCAATCAACCAACCCCGAC
AAGCATCGGCAATCAACGTACTATCGGAAG|AAGCATCGGCAATCAACTTCGGAAGTCTAA
AGCATCGGCAATCAACTAATAAGCATCGGC|GGCAATCAACCAAGTACCGCAAACCCCACC
TCGGCAATCAACTAACAACATCTGCCGTTG|AATCAACGACGCGTCCGATCTGGGGTGGGC
AATCAACTTGGCTAAACCAATCTGAGTCAA|GGTTAGGGTGATGATGAAGGTACAATCTCT
AACCCCGACTGGAGTAACATATGTATCATG|ACGGTGTCACTCGGCTCGGTCGTTCCATCT
GGTCGCCAATCGGAAGTCTAATAAGCATCG|ATTAGCAAGAAAGTATGGACGATCAGATTC
AAATCGCCTTCACTGCTCAAAGCCTCGGAA|TCGGCAATTCGGAAGTCTAATAAGCATCGG
TGACACTTCTCGGGTGGCCCCGAGAGTAGC|GTCTAATAAGCATCGGCAATCAACGTTATC
CGGCAATCAACTCGGAAGTCTCGGAAGTCT|TCGGCAATCAACGTTCGGAAGTCTAATAAG
ACTTGGCTAAACCAATCTGAGTCAAACATC|GGGTGATGATGAAGGTACAATCTCTCGTTT
GCTACATTTCGTACAAAGGGAGATATAACA|ACCCGCTCCCCAATAAGGTCTTGATGCGGG
ATCAACTAATAAGCATCGGCAATCAACCGG|CAAGTACCGCAAACCCCACCTCTTGTCGAA
ATCAACGTACTATCGGAAGTCTAATAAGCA|ATCAACTTCGGAAGTCTAATAAGCATCGGC
CATCGGCAATCAACTTGGCTAAACCAATCT|TAGCCAAGGTTAGGGTGATGATGAAGGTAC
TAAGCATCGGCAATCAACCGTCTCAAGTGT|ACCAACCCCGACTGGAGTAACATATGTATC
CGACACGCTCGGAAGTCTAATAAGCATCGG|CTCTCAAGTCGGAAGTCTAATAAGCATCGG
ACGTACTATCGGAAGTCTAATAAGCATCGG|ACTTCGGAAGTCTAATAAGCATCGGCAATC
TAAAATCGCCTTCACTGCTCAAAGCCTCGG|CATCGGCAATTCGGAAGTCTAATAAGCATC
AATAAGCATCGGCAATCAACTTCGGAAGTC|CGCCCAAGGATTTCTACATTGTAGGGGGAA
CGCTCGGAAGTCTAATAAGCATCGGCAATC|AAGTCGGAAGTCTAATAAGCATCGGCAATC
TATCGCCTGAGCCCACACAAGGTCGCACGG|CATACCTATATATCGGAAGTCTAATAAGCA
CTGCACGTCGAGAGTTACTCTGCGTCGGAA|GATGCTAGTTCTATATCTGTCAGGACCACT
TAACAACATCTGCCGTTGGATGAACGGTGT|GTCCGATCTGGGGTGGGCACCAGTAATTAT
CACTGCTCAAAGCCTCGGAAGTCTAATAAG|GGAAGTCTAATAAGCATCGGCAATCAACCA
GGACCTCTCGGAAGTCTAATAAGCATCGGC|TCAACGTACTATCGGAAGTCTAATAAGCAT
GCAATCAACCAAGTACCGCAAACCCCACCT|CTCAAGTGTTAAGCTGGGCAGGCCTATAAG
ACGACGCGTCCGATCTGGGGTGGGCACCAG|AAAGGGAGATATAACATGTGACTATAATTT
ACACTTCTCGGGTGGCCCCGAGAGTAGCCA|CTAATAAGCATCGGCAATCAACGTTATCGC
ATGGACGATCAGATTCGGTAATTGTTTCAT|GGTAGGAAATCCGGCACATCTGGAGTACCA
GTTTATGCGATGCTAGTTCTATATCTGTCA|CACGGACACCGGTGGCACACTCTGGGAGTA
TTCCATCTACGCTCTCAAGTCGGAAGTCTA|ACTGCCAGTTATTCTCTAATTAAGATGCAC
GTCTCGGAAGTCTAATAAGCATCGGCAATC|GAAGTCTAATAAGCATCGGCAATCAACCAA
GCAAGATCGTAACGCTAATAAGGATCTACT|AAGCGAGGACCTCTCGGAAGTCTAATAAGC
GTCTAATAAGCATCGGCAATCAACTACCTG|TAAGTAACTTACAGGTCGCCAATCGGAAGT
AATAAGCATCGGCAATCAACGTTCGGAAGT|GCTCAAAGCCTCGGAAGTCTAATAAGCATC
CGAGAGTTACTCTGCGTCGGAAGTCTAATA|TTCTATATCTGTCAGGACCACTTAAGTAAC
GGGTGATGATGAAGGTACAATCTCTCGTTT|CCACACAAGGTCGCACGGGAGTGCCCCACG
TCGGAAGTCTAATAAGCATCGGCAATCAAC|CAATCAACTAACAACATCTGCCGTTGGATG
CAGTTATTCTCTAATTAAGATGCACGCCCA|TTAGGATGAAGACGGGGACGGCGTTTACGT
GGACGATCAGATTCGGTAATTGTTTCATAC|TAGGAAATCCGGCACATCTGGAGTACCAGA
AATCTCTCGTTTATGCGATGCTAGTTCTAT|GAGTGCCCCACGGACACCGGTGGCACACTC
AATCAACTTCGGAAGTCTAATAAGCATCGG|CTACATTGTAGGGGGAAGATGCGCTACATT
ATCAACTTCGGAAGTCTAATAAGCATCGGC|TACATTGTAGGGGGAAGATGCGCTACATTT
GATAAAGGAGCGGTCAATCTGATTCCTCAC|GGAAGTCTAATAAGCATCGGCAATCAACTA
TCAATCTGATTCCTCACAGGCACTGCGCGT|GCATCGGCAATCAACTACCTGACACTTCTC
CGAGAGTAGCCAAGGTTAGGGTGATGATGA|CAACGTTATCGCCTGAGCCCACACAAGGTC
CAATCTGATTCCTCACAGGCACTGCGCGTC|CATCGGCAATCAACTACCTGACACTTCTCG
GATTCCTCACAGGCACTGCGCGTCGGAAGT|CAATCAACTACCTGACACTTCTCGGGTGGC
CAACTAACAACATCTGCCGTTGGATGAACG|ACGCGTCCGATCTGGGGTGGGCACCAGTAA
AGTAACATATGTATCATGTAGCGACACGCT|GGCTCGGTCGTTCCATCTACGCTCTCAAGT
AAGTCTAATAAGCATCGGCAATCAACGTAC|AAGTCTAATAAGCATCGGCAATCAACTTCG
GAGTACCAGAACACTAACTCGGAAGTCTAA|ATAAGGATCTACTAAAATCGCCTTCACTGC
CTTGTCGAATGTGCAAGATCGTAACGCTAA|CGGTCACCTTTAAAGCGAGGACCTCTCGGA
ATTGTTTCATACCTATATATCGGAAGTCTA|TGGAGTACCAGAACACTAACTCGGAAGTCT
CCGATCTGGGGTGGGCACCAGTAATTATGG|TATAACATGTGACTATAATTTCGATCTTCA
CTCGGAAGTCTCGGAAGTCTAATAAGCATC|ACGTTCGGAAGTCTAATAAGCATCGGCAAT
ACGGGAGTGCCCCACGGACACCGGTGGCAC|AGCATCGGCAATCAACTCGGAAGTCTCGGA
GTGGGCACCAGTAATTATGGATCGAAACCT|GACTATAATTTCGATCTTCACTGAGCTCAC
AATCTGAGTCAAACATCACAGCTGCACGTC|GGTACAATCTCTCGTTTATGCGATGCTAGT
ACCGGTGGCACACTCTGGGAGTAATTTGCG|GAAGTCTCGGAAGTCTAATAAGCATCGGCA
CACTTAAGTAACTTACAGGTCGCCAATCGG|GCGCAAAAAAACAACATATTAGCAAGAAAG
TCTCGGAAGTCTAATAAGCATCGGCAATTC|GTACTATCGGAAGTCTAATAAGCATCGGCA
TGCAAGATCGTAACGCTAATAAGGATCTAC|AAAGCGAGGACCTCTCGGAAGTCTAATAAG
GTTATCGCCTGAGCCCACACAAGGTCGCAC|TTCATACCTATATATCGGAAGTCTAATAAG
GCACTAAACTACGCTAACACGTGGATAAAG|CACGTCGAGAGTTACTCTGCGTCGGAAGTC
GAGCGGTCAATCTGATTCCTCACAGGCACT|TAATAAGCATCGGCAATCAACTACCTGACA
TCTCAAGTCGGAAGTCTAATAAGCATCGGC|TCTCTAATTAAGATGCACGCCCAAGGATTT
ATCAACGTTCGGAAGTCTAATAAGCATCGG|AAGTCTAATAAGCATCGGCAATCAACCGTC
TATATATCGGAAGTCTAATAAGCATCGGCA|CACTAACTCGGAAGTCTAATAAGCATCGGC
CGGCAATCAACCGGTAGGAAATCCGGCACA|CACCTCTTGTCGAATGTGCAAGATCGTAAC
TCGGCAATCAACGTACTATCGGAAGTCTAA|TCGGCAATCAACTTCGGAAGTCTAATAAGC
TGGCACACTCTGGGAGTAATTTGCGCAAAA|CTCGGAAGTCTAATAAGCATCGGCAATCAA
ACTAACTCGGAAGTCTAATAAGCATCGGCA|TAAAATCGCCTTCACTGCTCAAAGCCTCGG
ATAAGCATCGGCAATCAACGTTCGGAAGTC|CTCAAAGCCTCGGAAGTCTAATAAGCATCG
AACATCACAGCTGCACGTCGAGAGTTACTC|TCGTTTATGCGATGCTAGTTCTATATCTGT
CAACATCTGCCGTTGGATGAACGGTGTCAC|CGATCTGGGGTGGGCACCAGTAATTATGGA
AGCCCACACAAGGTCGCACGGGAGTGCCCC|ATATCGGAAGTCTAATAAGCATCGGCAATC
ATCGGCAATCAACTAACAACATCTGCCGTT|CAATCAACGACGCGTCCGATCTGGGGTGGG
GCCCCACGGACACCGGTGGCACACTCTGGG|CAATCAACTCGGAAGTCTCGGAAGTCTAAT
AGTACCAGAACACTAACTCGGAAGTCTAAT|TAAGGATCTACTAAAATCGCCTTCACTGCT
AGTCTAATAAGCATCGGCAATCAACTAACA|AATAAGCATCGGCAATCAACGACGCGTCCG
TTGACAACGTATGCACTAAACTACGCTAAC|ACATCACAGCTGCACGTCGAGAGTTACTCT
CAAACATCACAGCTGCACGTCGAGAGTTAC|TCTCGTTTATGCGATGCTAGTTCTATATCT
GAAAGTATGGACGATCAGATTCGGTAATTG|TCAACCGGTAGGAAATCCGGCACATCTGGA
CTAATAAGCATCGGCAATCAACGTTATCGC|GACGATCAGATTCGGTAATTGTTTCATACC
AATAAGCATCGGCAATCAACCGTCTCAAGT|CAACCAACCCCGACTGGAGTAACATATGTA
TCGTTCCATCTACGCTCTCAAGTCGGAAGT|GTCACTGCCAGTTATTCTCTAATTAAGATG
TGGGGTGGGCACCAGTAATTATGGATCGAA|ATGTGACTATAATTTCGATCTTCACTGAGC
TAATAAGCATCGGCAATCAACTACCTGACA|GTAACTTACAGGTCGCCAATCGGAAGTCTA
CAGGACCACTTAAGTAACTTACAGGTCGCC|TAATTTGCGCAAAAAAACAACATATTAGCA
GTCACCTTTAAAGCGAGGACCTCTCGGAAG|TAATAAGCATCGGCAATCAACGTACTATCG
AGCATCGGCAATCAACTCGGAAGTCTCGGA|AAGCATCGGCAATCAACGTTCGGAAGTCTA
AGGATCTACTAAAATCGCCTTCACTGCTCA|TCTAATAAGCATCGGCAATTCGGAAGTCTA
CATCGGCAATCAACTTCGGAAGTCTAATAA|AGGATTTCTACATTGTAGGGGGAAGATGCG
CACGTCGAGAGTTACTCTGCGTCGGAAGTC|GCTAGTTCTATATCTGTCAGGACCACTTAA
GATGATGAAGGTACAATCTCTCGTTTATGC|ACAAGGTCGCACGGGAGTGCCCCACGGACA
GATCGAAACCTGTCACTGCCAGTTATTCTC|ACTGAGCTCACACGACATGTTAGGATGAAG
CTGGGGTGGGCACCAGTAATTATGGATCGA|CATGTGACTATAATTTCGATCTTCACTGAG
GCATCGGCAATCAACCGTCTCAAGTGTTAA|AACCCCGACTGGAGTAACATATGTATCATG
GCCCCGAGAGTAGCCAAGGTTAGGGTGATG|CAATCAACGTTATCGCCTGAGCCCACACAA
GTCGAGAGTTACTCTGCGTCGGAAGTCTAA|AGTTCTATATCTGTCAGGACCACTTAAGTA
GCGACTTTGACAACGTATGCACTAAACTAC|AGTCAAACATCACAGCTGCACGTCGAGAGT
TAGCCAAGGTTAGGGTGATGATGAAGGTAC|TATCGCCTGAGCCCACACAAGGTCGCACGG
GTTAGGGTGATGATGAAGGTACAATCTCTC|GAGCCCACACAAGGTCGCACGGGAGTGCCC
TCGGAAGTCTAATAAGCATCGGCAATCAAC|GTCTAATAAGCATCGGCAATCAACCAAGTA
ATGAAGGTACAATCTCTCGTTTATGCGATG|GGTCGCACGGGAGTGCCCCACGGACACCGG
CGGCAATCAACGACGCGTCCGATCTGGGGT|ATTTCGTACAAAGGGAGATATAACATGTGA
AGCGGTCACCTTTAAAGCGAGGACCTCTCG|AGTCTAATAAGCATCGGCAATCAACGTACT
CGGAAGTCTAATAAGCATCGGCAATCAACC|AATCAACTAACAACATCTGCCGTTGGATGA
AGTCTAATAAGCATCGGCAATTCGGAAGTC|CGGAAGTCTAATAAGCATCGGCAATCAACT
AATAAGCATCGGCAATCAACTACCTGACAC|TAACTTACAGGTCGCCAATCGGAAGTCTAA
GGCAATCAACTAACAACATCTGCCGTTGGA|TCAACGACGCGTCCGATCTGGGGTGGGCAC
CAACCGGTAGGAAATCCGGCACATCTGGAG|TGTCGAATGTGCAAGATCGTAACGCTAATA
CGTCGGAAGTCTAATAAGCATCGGCAATCA|CTCGGGTGGCCCCGAGAGTAGCCAAGGTTA
AACTTACAGGTCGCCAATCGGAAGTCTAAT|AACAACATATTAGCAAGAAAGTATGGACGA
AAGTCTAATAAGCATCGGCAATCAACTTCG|GATGCACGCCCAAGGATTTCTACATTGTAG
GCGGTCAATCTGATTCCTCACAGGCACTGC|ATAAGCATCGGCAATCAACTACCTGACACT
GGGAAGATGCGCTACATTTCGTACAAAGGG|TTCCTGGGCGACCCGCTCCCCAATAAGGTC
CCCGAGAGTAGCCAAGGTTAGGGTGATGAT|ATCAACGTTATCGCCTGAGCCCACACAAGG
ATCGGCAATCAACCGGTAGGAAATCCGGCA|CCCACCTCTTGTCGAATGTGCAAGATCGTA
GATGCGCTACATTTCGTACAAAGGGAGATA|GGGCGACCCGCTCCCCAATAAGGTCTTGAT
ATAAAGGAGCGGTCAATCTGATTCCTCACA|GAAGTCTAATAAGCATCGGCAATCAACTAC
AACCAACCCCGACTGGAGTAACATATGTAT|ATGAACGGTGTCACTCGGCTCGGTCGTTCC
TCTAATAAGCATCGGCAATCAACCAAGTAC|CGGCAATCAACCGTCTCAAGTGTTAAGCTG
GGAAGATGCGCTACATTTCGTACAAAGGGA|TCCTGGGCGACCCGCTCCCCAATAAGGTCT
GTGTTAAGCTGGGCAGGCCTATAAGCGGTC|TATCATGTAGCGACACGCTCGGAAGTCTAA
TAGAACTCCACTGCGACTTTGACAACGTAT|TAAACCAATCTGAGTCAAACATCACAGCTG
CTGCGTCGGAAGTCTAATAAGCATCGGCAA|TCAGGACCACTTAAGTAACTTACAGGTCGC
ATCGGCAATCAACGTTCGGAAGTCTAATAA|GCCTCGGAAGTCTAATAAGCATCGGCAATC
AACTCGGAAGTCTAATAAGCATCGGCAATC|AATCGCCTTCACTGCTCAAAGCCTCGGAAG
CTAATAAGCATCGGCAATCAACTCGGAAGT|TCTAATAAGCATCGGCAATCAACGTTCGGA
CCCCACCTCTTGTCGAATGTGCAAGATCGT|CCTATAAGCGGTCACCTTTAAAGCGAGGAC
AGTCTAATAAGCATCGGCAATCAACTACCT|TTAAGTAACTTACAGGTCGCCAATCGGAAG
CGTAGAACTCCACTGCGACTTTGACAACGT|GCTAAACCAATCTGAGTCAAACATCACAGC
GGACACCGGTGGCACACTCTGGGAGTAATT|CTCGGAAGTCTCGGAAGTCTAATAAGCATC
GCCTTCACTGCTCAAAGCCTCGGAAGTCTA|AATTCGGAAGTCTAATAAGCATCGGCAATC
CGCCTTCACTGCTCAAAGCCTCGGAAGTCT|CAATTCGGAAGTCTAATAAGCATCGGCAAT
TCTAATAAGCATCGGCAATCAACTACCTGA|AAGTAACTTACAGGTCGCCAATCGGAAGTC
GACCACTTAAGTAACTTACAGGTCGCCAAT|TTTGCGCAAAAAAACAACATATTAGCAAGA
TGATTCCTCACAGGCACTGCGCGTCGGAAG|GCAATCAACTACCTGACACTTCTCGGGTGG
CAACCAACCCCGACTGGAGTAACATATGTA|GATGAACGGTGTCACTCGGCTCGGTCGTTC
TATATCTGTCAGGACCACTTAAGTAACTTA|CTCTGGGAGTAATTTGCGCAAAAAAACAAC
CCAAGGTTAGGGTGATGATGAAGGTACAAT|CGCCTGAGCCCACACAAGGTCGCACGGGAG
GGCACATCTGGAGTACCAGAACACTAACTC|CGTAACGCTAATAAGGATCTACTAAAATCG
GCCAGTTATTCTCTAATTAAGATGCACGCC|TGTTAGGATGAAGACGGGGACGGCGTTTAC
GTCTAATAAGCATCGGCAATCAACTTCGGA|TGCACGCCCAAGGATTTCTACATTGTAGGG
TCACAGGCACTGCGCGTCGGAAGTCTAATA|ACTACCTGACACTTCTCGGGTGGCCCCGAG
GCATCGGCAATCAACGACGCGTCCGATCTG|CTACATTTCGTACAAAGGGAGATATAACAT
ATCGTAACGCTAATAAGGATCTACTAAAAT|AGGACCTCTCGGAAGTCTAATAAGCATCGG
GAAGATGCGCTACATTTCGTACAAAGGGAG|CCTGGGCGACCCGCTCCCCAATAAGGTCTT
CTTACAGGTCGCCAATCGGAAGTCTAATAA|CAACATATTAGCAAGAAAGTATGGACGATC
TCGCACGGGAGTGCCCCACGGACACCGGTG|AATAAGCATCGGCAATCAACTCGGAAGTCT
TATGCACTAAACTACGCTAACACGTGGATA|CTGCACGTCGAGAGTTACTCTGCGTCGGAA
ACATATGTATCATGTAGCGACACGCTCGGA|CGGTCGTTCCATCTACGCTCTCAAGTCGGA
ATCAACCAAGTACCGCAAACCCCACCTCTT|AAGTGTTAAGCTGGGCAGGCCTATAAGCGG
AATAAGCATCGGCAATCAACTCGGAAGTCT|TAATAAGCATCGGCAATCAACGTTCGGAAG
GATTCGGTAATTGTTTCATACCTATATATC|CGGCACATCTGGAGTACCAGAACACTAACT
GGTGGGCACCAGTAATTATGGATCGAAACC|TGACTATAATTTCGATCTTCACTGAGCTCA
TGGAGTACCAGAACACTAACTCGGAAGTCT|TAATAAGGATCTACTAAAATCGCCTTCACT
TCTAATAAGCATCGGCAATCAACGTTCGGA|ACTGCTCAAAGCCTCGGAAGTCTAATAAGC
GCGTCGGAAGTCTAATAAGCATCGGCAATC|TCTCGGGTGGCCCCGAGAGTAGCCAAGGTT
CACATCTGGAGTACCAGAACACTAACTCGG|TAACGCTAATAAGGATCTACTAAAATCGCC
TCGGGTGGCCCCGAGAGTAGCCAAGGTTAG|GCATCGGCAATCAACGTTATCGCCTGAGCC
CACGGACACCGGTGGCACACTCTGGGAGTA|CAACTCGGAAGTCTCGGAAGTCTAATAAGC
ATCGGAAGTCTAATAAGCATCGGCAATCAA|GAAAGTATGGACGATCAGATTCGGTAATTG
TAAGCATCGGCAATCAACTACCTGACACTT|ACTTACAGGTCGCCAATCGGAAGTCTAATA
CGCTAACACGTGGATAAAGGAGCGGTCAAT|TTACTCTGCGTCGGAAGTCTAATAAGCATC
ATCAACGACGCGTCCGATCTGGGGTGGGCA|GTACAAAGGGAGATATAACATGTGACTATA
CGTTTATGCGATGCTAGTTCTATATCTGTC|CCACGGACACCGGTGGCACACTCTGGGAGT
ATGCGATGCTAGTTCTATATCTGTCAGGAC|GACACCGGTGGCACACTCTGGGAGTAATTT
ATTCGGTAATTGTTTCATACCTATATATCG|GGCACATCTGGAGTACCAGAACACTAACTC
AGTCTAATAAGCATCGGCAATCAACTTGGC|GGCCCCGAGAGTAGCCAAGGTTAGGGTGAT
CTCACAGGCACTGCGCGTCGGAAGTCTAAT|AACTACCTGACACTTCTCGGGTGGCCCCGA
TAATAAGCATCGGCAATCAACCAAGTACCG|GCAATCAACCGTCTCAAGTGTTAAGCTGGG
TAACATATGTATCATGTAGCGACACGCTCG|CTCGGTCGTTCCATCTACGCTCTCAAGTCG
ATCGGAAGTCTAATAAGCATCGGCAATCAA|AAGTCTAATAAGCATCGGCAATCAACGACG
CTCGGAAGTCTAATAAGCATCGGCAATTCG|TACTATCGGAAGTCTAATAAGCATCGGCAA
ATAAGCATCGGCAATCAACCGGTAGGAAAT|GCAAACCCCACCTCTTGTCGAATGTGCAAG
AAGGATTTCTACATTGTAGGGGGAAGATGC|TTCTTAAAGCTTTCCAAAATTTCCTGGGCG
AGCATCGGCAATCAACGTTCGGAAGTCTAA|AAAGCCTCGGAAGTCTAATAAGCATCGGCA
ACACCGGTGGCACACTCTGGGAGTAATTTG|CGGAAGTCTCGGAAGTCTAATAAGCATCGG
GGATTTCTACATTGTAGGGGGAAGATGCGC|CTTAAAGCTTTCCAAAATTTCCTGGGCGAC
GCCAAGGTTAGGGTGATGATGAAGGTACAA|TCGCCTGAGCCCACACAAGGTCGCACGGGA
TCTCAAGTGTTAAGCTGGGCAGGCCTATAA|CATATGTATCATGTAGCGACACGCTCGGAA
CCGGCACATCTGGAGTACCAGAACACTAAC|ATCGTAACGCTAATAAGGATCTACTAAAAT
CGGTAGGAAATCCGGCACATCTGGAGTACC|GAATGTGCAAGATCGTAACGCTAATAAGGA
ACCCCGACTGGAGTAACATATGTATCATGT|CGGTGTCACTCGGCTCGGTCGTTCCATCTA
GAAGTCTAATAAGCATCGGCAATCAACTAA|TAATAAGCATCGGCAATCAACCAAGTACCG
AGTCTAATAAGCATCGGCAATCAACCGTCT|GCAATCAACCAACCCCGACTGGAGTAACAT
ACTCTGCGTCGGAAGTCTAATAAGCATCGG|CTGTCAGGACCACTTAAGTAACTTACAGGT
TCTGCGTCGGAAGTCTAATAAGCATCGGCA|GTCAGGACCACTTAAGTAACTTACAGGTCG
AAGTATGGACGATCAGATTCGGTAATTGTT|AACCGGTAGGAAATCCGGCACATCTGGAGT
ATAAGCATCGGCAATCAACTCGGAAGTCTC|AATAAGCATCGGCAATCAACGTTCGGAAGT
GTAACTTACAGGTCGCCAATCGGAAGTCTA|AAAACAACATATTAGCAAGAAAGTATGGAC
CTCGGAAGTCTAATAAGCATCGGCAATCAA|TCGCCTTCACTGCTCAAAGCCTCGGAAGTC
TAAGCATCGGCAATCAACTCGGAAGTCTCG|ATAAGCATCGGCAATCAACGTTCGGAAGTC
GCACATCTGGAGTACCAGAACACTAACTCG|GTAACGCTAATAAGGATCTACTAAAATCGC
ACAACATATTAGCAAGAAAGTATGGACGAT|AATAAGCATCGGCAATCAACCGGTAGGAAA
AAGTCTCGGAAGTCTAATAAGCATCGGCAA|CGGAAGTCTAATAAGCATCGGCAATCAACC
TCTAATAAGCATCGGCAATCAACTCGGAAG|GTCTAATAAGCATCGGCAATCAACGTTCGG
TCAACCGGTAGGAAATCCGGCACATCTGGA|TTGTCGAATGTGCAAGATCGTAACGCTAAT
CGACGCGTCCGATCTGGGGTGGGCACCAGT|AAGGGAGATATAACATGTGACTATAATTTC
GCGATGCTAGTTCTATATCTGTCAGGACCA|CACCGGTGGCACACTCTGGGAGTAATTTGC
CTGCGCGTCGGAAGTCTAATAAGCATCGGC|CACTTCTCGGGTGGCCCCGAGAGTAGCCAA
TAAACCAATCTGAGTCAAACATCACAGCTG|GATGAAGGTACAATCTCTCGTTTATGCGAT
ACCGCAAACCCCACCTCTTGTCGAATGTGC|TGGGCAGGCCTATAAGCGGTCACCTTTAAA
GCAATCAACTACCTGACACTTCTCGGGTGG|TCGCCAATCGGAAGTCTAATAAGCATCGGC
CGATCAGATTCGGTAATTGTTTCATACCTA|GAAATCCGGCACATCTGGAGTACCAGAACA
TTAGCAAGAAAGTATGGACGATCAGATTCG|TCGGCAATCAACCGGTAGGAAATCCGGCAC
AAAAAAACAACATATTAGCAAGAAAGTATG|TCAACTAATAAGCATCGGCAATCAACCGGT
CACTTCTCGGGTGGCCCCGAGAGTAGCCAA|TAATAAGCATCGGCAATCAACGTTATCGCC
ACACGTGGATAAAGGAGCGGTCAATCTGAT|CTGCGTCGGAAGTCTAATAAGCATCGGCAA
AGTATGGACGATCAGATTCGGTAATTGTTT|ACCGGTAGGAAATCCGGCACATCTGGAGTA
GAGAGTAGCCAAGGTTAGGGTGATGATGAA|AACGTTATCGCCTGAGCCCACACAAGGTCG
TATTAGCAAGAAAGTATGGACGATCAGATT|CATCGGCAATCAACCGGTAGGAAATCCGGC
TGGGCACCAGTAATTATGGATCGAAACCTG|ACTATAATTTCGATCTTCACTGAGCTCACA
GCATCGGCAATCAACCAACCCCGACTGGAG|ATCTGCCGTTGGATGAACGGTGTCACTCGG
TAAGCATCGGCAATTCGGAAGTCTAATAAG|CTAATAAGCATCGGCAATCAACTAACAACA
GCCGTTGGATGAACGGTGTCACTCGGCTCG|GGTGGGCACCAGTAATTATGGATCGAAACC
AAGCATCGGCAATCAACTAATAAGCATCGG|CGGCAATCAACCAAGTACCGCAAACCCCAC
TCAACTAATAAGCATCGGCAATCAACCGGT|AAGTACCGCAAACCCCACCTCTTGTCGAAT
AATAAGCATCGGCAATCAACGTTATCGCCT|CGATCAGATTCGGTAATTGTTTCATACCTA
CGCAAACCCCACCTCTTGTCGAATGTGCAA|GGCAGGCCTATAAGCGGTCACCTTTAAAGC
TCCGATCTGGGGTGGGCACCAGTAATTATG|ATATAACATGTGACTATAATTTCGATCTTC
AAGTCTAATAAGCATCGGCAATCAACTTGG|TGGCCCCGAGAGTAGCCAAGGTTAGGGTGA
AATCAACTACCTGACACTTCTCGGGTGGCC|GCCAATCGGAAGTCTAATAAGCATCGGCAA
GCTAGTTCTATATCTGTCAGGACCACTTAA|GTGGCACACTCTGGGAGTAATTTGCGCAAA
CGGTCACCTTTAAAGCGAGGACCTCTCGGA|TCTAATAAGCATCGGCAATCAACGTACTAT
TGTATCATGTAGCGACACGCTCGGAAGTCT|GTTCCATCTACGCTCTCAAGTCGGAAGTCT
GGTAGGAAATCCGGCACATCTGGAGTACCA|AATGTGCAAGATCGTAACGCTAATAAGGAT
AAGCATCGGCAATCAACTTCGGAAGTCTAA|CCAAGGATTTCTACATTGTAGGGGGAAGAT
CAACGTACTATCGGAAGTCTAATAAGCATC|CAACTTCGGAAGTCTAATAAGCATCGGCAA
AGTCGGAAGTCTAATAAGCATCGGCAATCA|AATTAAGATGCACGCCCAAGGATTTCTACA
GCTCGGAAGTCTAATAAGCATCGGCAATCA|AGTCGGAAGTCTAATAAGCATCGGCAATCA
GAAGTCTAATAAGCATCGGCAATCAACGAC|GGGGAAGATGCGCTACATTTCGTACAAAGG
GAATGTGCAAGATCGTAACGCTAATAAGGA|CCTTTAAAGCGAGGACCTCTCGGAAGTCTA
ATATTAGCAAGAAAGTATGGACGATCAGAT|GCATCGGCAATCAACCGGTAGGAAATCCGG
GTAACATATGTATCATGTAGCGACACGCTC|GCTCGGTCGTTCCATCTACGCTCTCAAGTC
CTACTAAAATCGCCTTCACTGCTCAAAGCC|TAAGCATCGGCAATTCGGAAGTCTAATAAG
GGCAATCAACTTGGCTAAACCAATCTGAGT|CAAGGTTAGGGTGATGATGAAGGTACAATC
CGGCTCGGTCGTTCCATCTACGCTCTCAAG|CGAAACCTGTCACTGCCAGTTATTCTCTAA
AAACCCCACCTCTTGTCGAATGTGCAAGAT|AGGCCTATAAGCGGTCACCTTTAAAGCGAG
CTGGGAGTAATTTGCGCAAAAAAACAACAT|CTAATAAGCATCGGCAATCAACTAATAAGC
GCCCACACAAGGTCGCACGGGAGTGCCCCA|TATCGGAAGTCTAATAAGCATCGGCAATCA
ACCAACCCCGACTGGAGTAACATATGTATC|TGAACGGTGTCACTCGGCTCGGTCGTTCCA
TGGATCGAAACCTGTCACTGCCAGTTATTC|TCACTGAGCTCACACGACATGTTAGGATGA
GTCTAATAAGCATCGGCAATCAACGACGCG|GAAGATGCGCTACATTTCGTACAAAGGGAG
AACTACGCTAACACGTGGATAAAGGAGCGG|GAGAGTTACTCTGCGTCGGAAGTCTAATAA
GCCTCGGAAGTCTAATAAGCATCGGCAATC|AAGCATCGGCAATCAACCAACCCCGACTGG
CAACTTGGCTAAACCAATCTGAGTCAAACA|TAGGGTGATGATGAAGGTACAATCTCTCGT
GGAAGTCTAATAAGCATCGGCAATCAACTA|CTAATAAGCATCGGCAATCAACCAAGTACC
CCTATATATCGGAAGTCTAATAAGCATCGG|AACACTAACTCGGAAGTCTAATAAGCATCG
AGCGACACGCTCGGAAGTCTAATAAGCATC|CGCTCTCAAGTCGGAAGTCTAATAAGCATC
TTGGCTAAACCAATCTGAGTCAAACATCAC|GTGATGATGAAGGTACAATCTCTCGTTTAT
CATTGTAGGGGGAAGATGCGCTACATTTCG|TTCCAAAATTTCCTGGGCGACCCGCTCCCC
GGCAATCAACGTTATCGCCTGAGCCCACAC|CGGTAATTGTTTCATACCTATATATCGGAA
TTATTCTCTAATTAAGATGCACGCCCAAGG|GGATGAAGACGGGGACGGCGTTTACGTTCT
GTCTAATAAGCATCGGCAATCAACGTTCGG|CACTGCTCAAAGCCTCGGAAGTCTAATAAG
GACACTTCTCGGGTGGCCCCGAGAGTAGCC|TCTAATAAGCATCGGCAATCAACGTTATCG
GGAAGTCTAATAAGCATCGGCAATCAACTT|AAGATGCACGCCCAAGGATTTCTACATTGT
CGTTCGGAAGTCTAATAAGCATCGGCAATC|TAATAAGCATCGGCAATCAACCGTCTCAAG
CCATCTACGCTCTCAAGTCGGAAGTCTAAT|TGCCAGTTATTCTCTAATTAAGATGCACGC
TGCACGTCGAGAGTTACTCTGCGTCGGAAG|ATGCTAGTTCTATATCTGTCAGGACCACTT
AGCATCGGCAATCAACCGTCTCAAGTGTTA|CAACCCCGACTGGAGTAACATATGTATCAT
AATCAACGTTCGGAAGTCTAATAAGCATCG|GAAGTCTAATAAGCATCGGCAATCAACCGT
AGAGTAGCCAAGGTTAGGGTGATGATGAAG|ACGTTATCGCCTGAGCCCACACAAGGTCGC
TATCGGAAGTCTAATAAGCATCGGCAATCA|AACTCGGAAGTCTAATAAGCATCGGCAATC
CAACGTTATCGCCTGAGCCCACACAAGGTC|TTGTTTCATACCTATATATCGGAAGTCTAA
CTGCTCAAAGCCTCGGAAGTCTAATAAGCA|AAGTCTAATAAGCATCGGCAATCAACCAAC
GTAGCGACACGCTCGGAAGTCTAATAAGCA|TACGCTCTCAAGTCGGAAGTCTAATAAGCA
GAACACTAACTCGGAAGTCTAATAAGCATC|CTACTAAAATCGCCTTCACTGCTCAAAGCC
TTATGCGATGCTAGTTCTATATCTGTCAGG|CGGACACCGGTGGCACACTCTGGGAGTAAT
GGCCCCGAGAGTAGCCAAGGTTAGGGTGAT|GCAATCAACGTTATCGCCTGAGCCCACACA
ACTTAAGTAACTTACAGGTCGCCAATCGGA|CGCAAAAAAACAACATATTAGCAAGAAAGT
ATCAGATTCGGTAATTGTTTCATACCTATA|AATCCGGCACATCTGGAGTACCAGAACACT
AGCCTCGGAAGTCTAATAAGCATCGGCAAT|TAAGCATCGGCAATCAACCAACCCCGACTG
GCATCGGCAATCAACGTTCGGAAGTCTAAT|AAGCCTCGGAAGTCTAATAAGCATCGGCAA
TCGGTAATTGTTTCATACCTATATATCGGA|CACATCTGGAGTACCAGAACACTAACTCGG
GATGAACGGTGTCACTCGGCTCGGTCGTTC|ACCAGTAATTATGGATCGAAACCTGTCACT
AGGAAATCCGGCACATCTGGAGTACCAGAA|GTGCAAGATCGTAACGCTAATAAGGATCTA
TCTGAGTCAAACATCACAGCTGCACGTCGA|TACAATCTCTCGTTTATGCGATGCTAGTTC
CGCCTGAGCCCACACAAGGTCGCACGGGAG|ACCTATATATCGGAAGTCTAATAAGCATCG
CTGACACTTCTCGGGTGGCCCCGAGAGTAG|AGTCTAATAAGCATCGGCAATCAACGTTAT
CCGTCTCAAGTGTTAAGCTGGGCAGGCCTA|TAACATATGTATCATGTAGCGACACGCTCG
TCTATATCTGTCAGGACCACTTAAGTAACT|CACTCTGGGAGTAATTTGCGCAAAAAAACA
TCAACGTACTATCGGAAGTCTAATAAGCAT|TCAACTTCGGAAGTCTAATAAGCATCGGCA
ATGAACGGTGTCACTCGGCTCGGTCGTTCC|CCAGTAATTATGGATCGAAACCTGTCACTG
ACTCCACTGCGACTTTGACAACGTATGCAC|CCAATCTGAGTCAAACATCACAGCTGCACG
ATCGGCAATCAACTTGGCTAAACCAATCTG|AGCCAAGGTTAGGGTGATGATGAAGGTACA
GTCTAATAAGCATCGGCAATCAACCGTCTC|CAATCAACCAACCCCGACTGGAGTAACATA
CGTGGATAAAGGAGCGGTCAATCTGATTCC|CGTCGGAAGTCTAATAAGCATCGGCAATCA
TAATTGTTTCATACCTATATATCGGAAGTC|TCTGGAGTACCAGAACACTAACTCGGAAGT
TAAGCATCGGCAATCAACTAACAACATCTG|ATCGGCAATCAACGACGCGTCCGATCTGGG
TGCGCTACATTTCGTACAAAGGGAGATATA|GCGACCCGCTCCCCAATAAGGTCTTGATGC
CAATCAACTCGGAAGTCTCGGAAGTCTAAT|GCAATCAACGTTCGGAAGTCTAATAAGCAT
AACTAATAAGCATCGGCAATCAACCGGTAG|GTACCGCAAACCCCACCTCTTGTCGAATGT
TGCGTCGGAAGTCTAATAAGCATCGGCAAT|CAGGACCACTTAAGTAACTTACAGGTCGCC
CGGAAGTCTAATAAGCATCGGCAATCAACT|GTCTAATAAGCATCGGCAATCAACGACGCG
GCAATCAACGACGCGTCCGATCTGGGGTGG|TTCGTACAAAGGGAGATATAACATGTGACT
CGGCAATCAACTAATAAGCATCGGCAATCA|TCAACCAAGTACCGCAAACCCCACCTCTTG
TCGTTTATGCGATGCTAGTTCTATATCTGT|CCCACGGACACCGGTGGCACACTCTGGGAG
ATGATGAAGGTACAATCTCTCGTTTATGCG|CAAGGTCGCACGGGAGTGCCCCACGGACAC
CTAAAATCGCCTTCACTGCTCAAAGCCTCG|GCATCGGCAATTCGGAAGTCTAATAAGCAT
TCTCTCGTTTATGCGATGCTAGTTCTATAT|GTGCCCCACGGACACCGGTGGCACACTCTG
AAGCATCGGCAATCAACCAAGTACCGCAAA|TCAACCGTCTCAAGTGTTAAGCTGGGCAGG
ATTTCTACATTGTAGGGGGAAGATGCGCTA|TAAAGCTTTCCAAAATTTCCTGGGCGACCC
TCCACTGCGACTTTGACAACGTATGCACTA|AATCTGAGTCAAACATCACAGCTGCACGTC
CTTTGACAACGTATGCACTAAACTACGCTA|AAACATCACAGCTGCACGTCGAGAGTTACT
ATCGGCAATCAACCAACCCCGACTGGAGTA|CTGCCGTTGGATGAACGGTGTCACTCGGCT
TAAGCATCGGCAATCAACGTTCGGAAGTCT|TCAAAGCCTCGGAAGTCTAATAAGCATCGG
ATCTGCCGTTGGATGAACGGTGTCACTCGG|CTGGGGTGGGCACCAGTAATTATGGATCGA
GTCACTGCCAGTTATTCTCTAATTAAGATG|ACGACATGTTAGGATGAAGACGGGGACGGC
ATAAGCATCGGCAATCAACTACCTGACACT|AACTTACAGGTCGCCAATCGGAAGTCTAAT
TCACAGCTGCACGTCGAGAGTTACTCTGCG|TTATGCGATGCTAGTTCTATATCTGTCAGG
TAAGCATCGGCAATCAACGACGCGTCCGAT|GCGCTACATTTCGTACAAAGGGAGATATAA
GTCAATCTGATTCCTCACAGGCACTGCGCG|AGCATCGGCAATCAACTACCTGACACTTCT
CTAACACGTGGATAAAGGAGCGGTCAATCT|ACTCTGCGTCGGAAGTCTAATAAGCATCGG
AATCAACTCGGAAGTCTCGGAAGTCTAATA|CAATCAACGTTCGGAAGTCTAATAAGCATC
AGTAATTATGGATCGAAACCTGTCACTGCC|TTCGATCTTCACTGAGCTCACACGACATGT
CTAACTCGGAAGTCTAATAAGCATCGGCAA|AAAATCGCCTTCACTGCTCAAAGCCTCGGA
AAGATGCGCTACATTTCGTACAAAGGGAGA|CTGGGCGACCCGCTCCCCAATAAGGTCTTG
GTTTCATACCTATATATCGGAAGTCTAATA|AGTACCAGAACACTAACTCGGAAGTCTAAT
AAAATCGCCTTCACTGCTCAAAGCCTCGGA|ATCGGCAATTCGGAAGTCTAATAAGCATCG
AGTGTTAAGCTGGGCAGGCCTATAAGCGGT|GTATCATGTAGCGACACGCTCGGAAGTCTA
CGGAAGTCTAATAAGCATCGGCAATCAACT|GGGTGGCCCCGAGAGTAGCCAAGGTTAGGG
CTATATATCGGAAGTCTAATAAGCATCGGC|ACACTAACTCGGAAGTCTAATAAGCATCGG
ACGCGTCCGATCTGGGGTGGGCACCAGTAA|GGGAGATATAACATGTGACTATAATTTCGA
ATATGTATCATGTAGCGACACGCTCGGAAG|GTCGTTCCATCTACGCTCTCAAGTCGGAAG
AATTCGGAAGTCTAATAAGCATCGGCAATC|CGGCAATCAACTAACAACATCTGCCGTTGG
TCAACCGTCTCAAGTGTTAAGCTGGGCAGG|GGAGTAACATATGTATCATGTAGCGACACG
CGGGAGTGCCCCACGGACACCGGTGGCACA|GCATCGGCAATCAACTCGGAAGTCTCGGAA
GTCCGATCTGGGGTGGGCACCAGTAATTAT|GATATAACATGTGACTATAATTTCGATCTT
CAACTTCGGAAGTCTAATAAGCATCGGCAA|CATTGTAGGGGGAAGATGCGCTACATTTCG
ACCAGAACACTAACTCGGAAGTCTAATAAG|GGATCTACTAAAATCGCCTTCACTGCTCAA
AAAGGAGCGGTCAATCTGATTCCTCACAGG|AGTCTAATAAGCATCGGCAATCAACTACCT
AGCATCGGCAATCAACTAACAACATCTGCC|CGGCAATCAACGACGCGTCCGATCTGGGGT
CTGTCAGGACCACTTAAGTAACTTACAGGT|GGAGTAATTTGCGCAAAAAAACAACATATT
ACTAAAATCGCCTTCACTGCTCAAAGCCTC|AGCATCGGCAATTCGGAAGTCTAATAAGCA
TATTCTCTAATTAAGATGCACGCCCAAGGA|GATGAAGACGGGGACGGCGTTTACGTTCTT
TAAGCATCGGCAATCAACCAACCCCGACTG|AACATCTGCCGTTGGATGAACGGTGTCACT
AGGTCGCCAATCGGAAGTCTAATAAGCATC|TATTAGCAAGAAAGTATGGACGATCAGATT
ACTAACAACATCTGCCGTTGGATGAACGGT|GCGTCCGATCTGGGGTGGGCACCAGTAATT
TGAGCCCACACAAGGTCGCACGGGAGTGCC|ATATATCGGAAGTCTAATAAGCATCGGCAA
GAAGTCTAATAAGCATCGGCAATCAACTTG|GTGGCCCCGAGAGTAGCCAAGGTTAGGGTG
ACTGCGCGTCGGAAGTCTAATAAGCATCGG|ACACTTCTCGGGTGGCCCCGAGAGTAGCCA
GCGGTCACCTTTAAAGCGAGGACCTCTCGG|GTCTAATAAGCATCGGCAATCAACGTACTA
TAATAAGCATCGGCAATCAACTCGGAAGTC|CTAATAAGCATCGGCAATCAACGTTCGGAA
AATCAACTAATAAGCATCGGCAATCAACCG|CCAAGTACCGCAAACCCCACCTCTTGTCGA
GTCTAATAAGCATCGGCAATCAACTCGGAA|AGTCTAATAAGCATCGGCAATCAACGTTCG
AACTTGGCTAAACCAATCTGAGTCAAACAT|AGGGTGATGATGAAGGTACAATCTCTCGTT
